sample_id,homozygous_reference_alleles,homozygous_alternate_alleles,heterozygous_alternate_alleles,total_callable_sites,total_snvs,percentage_heterozygous_alternate_alleles,percentage_homozygous_alternate_alleles
HG00356,1278953,39471,62292,1380716,101763,61.2128,38.7872
HG00341,1310112,70604,0,1380716,70604,0.0,100.0
NA20507,1279732,37616,63368,1380716,100984,62.7505,37.2495
NA18543,1307456,73260,0,1380716,73260,0.0,100.0
NA19396,1230100,48404,102212,1380716,150616,67.8626,32.1374
NA19160,1276534,104182,0,1380716,104182,0.0,100.0
NA20282,1229390,50970,100356,1380716,151326,66.3178,33.6822
NA19235,1224613,51447,104656,1380716,156103,67.0429,32.9571
NA20529,1277450,38369,64897,1380716,103266,62.8445,37.1555
NA19175,1278013,102703,0,1380716,102703,0.0,100.0
HG00362,1280608,39657,60451,1380716,100108,60.3858,39.6142
NA12748,1310583,70133,0,1380716,70133,0.0,100.0
NA20787,1309527,71189,0,1380716,71189,0.0,100.0
HG00276,1275771,40509,64436,1380716,104945,61.3998,38.6002
NA19064,1275396,47537,57783,1380716,105320,54.8642,45.1358
HG00662,1305920,74796,0,1380716,74796,0.0,100.0
HG00096,1308309,72407,0,1380716,72407,0.0,100.0
NA19401,1226927,48900,104889,1380716,153789,68.2032,31.7968
NA19750,1308320,72396,0,1380716,72396,0.0,100.0
HG00253,1276424,38762,65530,1380716,104292,62.8332,37.1668
NA19429,1277166,103550,0,1380716,103550,0.0,100.0
NA19197,1227477,52055,101184,1380716,153239,66.0302,33.9698
HG00343,1279802,44074,56840,1380716,100914,56.3252,43.6748
NA12717,1275789,40598,64329,1380716,104927,61.3083,38.6917
HG00189,1308271,72445,0,1380716,72445,0.0,100.0
HG00266,1279976,41360,59380,1380716,100740,58.9438,41.0562
HG00689,1304134,76582,0,1380716,76582,0.0,100.0
NA18547,1283133,45887,51696,1380716,97583,52.9764,47.0236
NA11920,1276637,39400,64679,1380716,104079,62.1441,37.8559
HG00103,1308150,72566,0,1380716,72566,0.0,100.0
NA19445,1222998,50763,106955,1380716,157718,67.8141,32.1859
HG00321,1308315,72401,0,1380716,72401,0.0,100.0
NA12006,1280030,39881,60805,1380716,100686,60.3907,39.6093
HG00583,1303911,76805,0,1380716,76805,0.0,100.0
NA19359,1276043,104673,0,1380716,104673,0.0,100.0
HG00513,1275264,47572,57880,1380716,105452,54.8875,45.1125
HG00113,1309456,71260,0,1380716,71260,0.0,100.0
NA12750,1309731,70985,0,1380716,70985,0.0,100.0
NA18636,1307094,73622,0,1380716,73622,0.0,100.0
NA18599,1278570,45545,56601,1380716,102146,55.4119,44.5881
HG00501,1273506,47633,59577,1380716,107210,55.5704,44.4296
HG00187,1308442,72274,0,1380716,72274,0.0,100.0
NA19312,1277515,103201,0,1380716,103201,0.0,100.0
NA18576,1279151,46490,55075,1380716,101565,54.2264,45.7736
NA20805,1307111,73605,0,1380716,73605,0.0,100.0
NA20766,1277981,39339,63396,1380716,102735,61.7083,38.2917
NA18740,1308670,72046,0,1380716,72046,0.0,100.0
HG00173,1278682,41517,60517,1380716,102034,59.3106,40.6894
HG01259,1310789,69927,0,1380716,69927,0.0,100.0
NA18946,1278460,42779,59477,1380716,102256,58.1648,41.8352
NA19453,1275674,105042,0,1380716,105042,0.0,100.0
NA18611,1306964,73752,0,1380716,73752,0.0,100.0
NA18982,1306280,74436,0,1380716,74436,0.0,100.0
HG00125,1277660,40027,63029,1380716,103056,61.16,38.84
NA19982,1277744,102972,0,1380716,102972,0.0,100.0
NA19728,1279804,48361,52551,1380716,100912,52.0761,47.9239
HG00531,1279621,47235,53860,1380716,101095,53.2766,46.7234
HG00537,1275699,50573,54444,1380716,105017,51.843,48.157
NA12413,1308742,71974,0,1380716,71974,0.0,100.0
NA18626,1276523,48984,55209,1380716,104193,52.9872,47.0128
HG00372,1307970,72746,0,1380716,72746,0.0,100.0
NA18954,1278405,44702,57609,1380716,102311,56.3077,43.6923
NA19062,1304968,75748,0,1380716,75748,0.0,100.0
NA19652,1307456,73260,0,1380716,73260,0.0,100.0
HG00360,1310099,70617,0,1380716,70617,0.0,100.0
NA18610,1277884,45197,57635,1380716,102832,56.0477,43.9523
NA19731,1279722,51608,49386,1380716,100994,48.8999,51.1001
NA20818,1278773,42161,59782,1380716,101943,58.6426,41.3574
HG01097,1303234,77482,0,1380716,77482,0.0,100.0
NA20503,1276143,42052,62521,1380716,104573,59.7869,40.2131
HG01441,1276313,44332,60071,1380716,104403,57.5376,42.4624
HG01069,1306766,73950,0,1380716,73950,0.0,100.0
HG00240,1274230,38854,67632,1380716,106486,63.5126,36.4874
HG01374,1308150,72566,0,1380716,72566,0.0,100.0
HG00272,1272623,41006,67087,1380716,108093,62.0641,37.9359
HG01060,1300116,80600,0,1380716,80600,0.0,100.0
HG00614,1279062,49087,52567,1380716,101654,51.7117,48.2883
HG00634,1305107,75609,0,1380716,75609,0.0,100.0
HG01516,1279560,42350,58806,1380716,101156,58.134,41.866
HG01625,1309365,71351,0,1380716,71351,0.0,100.0
NA18942,1280665,47629,52422,1380716,100051,52.3953,47.6047
HG00315,1278784,43239,58693,1380716,101932,57.5805,42.4195
NA18630,1279209,46772,54735,1380716,101507,53.9224,46.0776
HG00118,1276496,40415,63805,1380716,104220,61.2215,38.7785
NA19780,1306932,73784,0,1380716,73784,0.0,100.0
HG00137,1281670,40442,58604,1380716,99046,59.1685,40.8315
NA18984,1301185,79531,0,1380716,79531,0.0,100.0
NA10851,1310393,70323,0,1380716,70323,0.0,100.0
HG01075,1305459,75257,0,1380716,75257,0.0,100.0
NA18574,1274492,48122,58102,1380716,106224,54.6976,45.3024
HG00595,1304856,75860,0,1380716,75860,0.0,100.0
HG01365,1299593,81123,0,1380716,81123,0.0,100.0
NA20809,1310852,69864,0,1380716,69864,0.0,100.0
NA18628,1279704,48156,52856,1380716,101012,52.3265,47.6735
NA19147,1228805,52904,99007,1380716,151911,65.1743,34.8257
NA20339,1228326,47133,105257,1380716,152390,69.0708,30.9292
NA18617,1274566,47905,58245,1380716,106150,54.8705,45.1295
NA11894,1273683,43048,63985,1380716,107033,59.7806,40.2194
HG01133,1305679,75037,0,1380716,75037,0.0,100.0
HG00143,1307865,72851,0,1380716,72851,0.0,100.0
NA18874,1278368,102348,0,1380716,102348,0.0,100.0
HG00332,1275645,39018,66053,1380716,105071,62.8651,37.1349
HG00258,1278646,43066,59004,1380716,102070,57.8074,42.1926
NA19704,1231135,39296,110285,1380716,149581,73.7293,26.2707
NA20810,1307619,73097,0,1380716,73097,0.0,100.0
NA19213,1276430,104286,0,1380716,104286,0.0,100.0
NA18624,1303484,77232,0,1380716,77232,0.0,100.0
NA19722,1272918,40482,67316,1380716,107798,62.4464,37.5536
HG00345,1304526,76190,0,1380716,76190,0.0,100.0
NA20585,1278281,42751,59684,1380716,102435,58.2652,41.7348
HG01522,1279420,42711,58585,1380716,101296,57.8355,42.1645
NA18916,1226459,49617,104640,1380716,154257,67.8348,32.1652
HG01437,1309287,71429,0,1380716,71429,0.0,100.0
NA19752,1279999,45333,55384,1380716,100717,54.9897,45.0103
NA20828,1277145,40185,63386,1380716,103571,61.2005,38.7995
NA20509,1310369,70347,0,1380716,70347,0.0,100.0
HG00708,1278282,47277,55157,1380716,102434,53.8464,46.1536
NA19984,1279385,101331,0,1380716,101331,0.0,100.0
HG00231,1277594,40457,62665,1380716,103122,60.7678,39.2322
NA19236,1275861,104855,0,1380716,104855,0.0,100.0
HG01173,1310188,70528,0,1380716,70528,0.0,100.0
NA18909,1228282,54038,98396,1380716,152434,64.5499,35.4501
NA07048,1310396,70320,0,1380716,70320,0.0,100.0
HG00357,1281071,43129,56516,1380716,99645,56.7173,43.2827
NA19099,1226878,48195,105643,1380716,153838,68.6716,31.3284
HG01383,1307303,73413,0,1380716,73413,0.0,100.0
HG00448,1306868,73848,0,1380716,73848,0.0,100.0
NA19371,1277971,102745,0,1380716,102745,0.0,100.0
HG01619,1311698,69018,0,1380716,69018,0.0,100.0
HG00475,1307072,73644,0,1380716,73644,0.0,100.0
NA19474,1226142,51487,103087,1380716,154574,66.691,33.309
NA20757,1279694,42924,58098,1380716,101022,57.5102,42.4898
HG00138,1311635,69081,0,1380716,69081,0.0,100.0
NA12383,1275208,40421,65087,1380716,105508,61.6892,38.3108
NA19190,1226995,54151,99570,1380716,153721,64.7732,35.2268
NA19444,1281905,98811,0,1380716,98811,0.0,100.0
NA18640,1277014,45638,58064,1380716,103702,55.9912,44.0088
NA19054,1280891,49986,49839,1380716,99825,49.9264,50.0736
HG00106,1276652,42066,61998,1380716,104064,59.5768,40.4232
NA20357,1226629,50860,103227,1380716,154087,66.9927,33.0073
HG00140,1311050,69666,0,1380716,69666,0.0,100.0
NA19455,1277915,102801,0,1380716,102801,0.0,100.0
HG00683,1303816,76900,0,1380716,76900,0.0,100.0
NA19093,1228132,53867,98717,1380716,152584,64.6968,35.3032
HG01377,1297473,83243,0,1380716,83243,0.0,100.0
HG00334,1273371,41778,65567,1380716,107345,61.0806,38.9194
NA20504,1275331,40967,64418,1380716,105385,61.1263,38.8737
NA20581,1307889,72827,0,1380716,72827,0.0,100.0
NA18563,1304904,75812,0,1380716,75812,0.0,100.0
NA19734,1278158,45839,56719,1380716,102558,55.3043,44.6957
NA20808,1273312,41413,65991,1380716,107404,61.4418,38.5582
NA19435,1226514,49630,104572,1380716,154202,67.8149,32.1851
NA20759,1310627,70089,0,1380716,70089,0.0,100.0
HG00249,1278316,39013,63387,1380716,102400,61.9014,38.0986
HG00653,1304845,75871,0,1380716,75871,0.0,100.0
NA19788,1274068,46413,60235,1380716,106648,56.4802,43.5198
NA18501,1278651,102065,0,1380716,102065,0.0,100.0
NA19681,1267419,40511,72786,1380716,113297,64.2435,35.7565
NA20801,1307651,73065,0,1380716,73065,0.0,100.0
NA18502,1229596,50617,100503,1380716,151120,66.5054,33.4946
NA19372,1275523,105193,0,1380716,105193,0.0,100.0
NA20582,1280099,42723,57894,1380716,100617,57.539,42.461
HG00635,1276106,46220,58390,1380716,104610,55.8168,44.1832
NA20314,1279376,45011,56329,1380716,101340,55.5842,44.4158
HG00247,1276362,41278,63076,1380716,104354,60.4443,39.5557
NA19920,1277694,103022,0,1380716,103022,0.0,100.0
NA12287,1279955,42703,58058,1380716,100761,57.6195,42.3805
NA19625,1240214,39794,100708,1380716,140502,71.6773,28.3227
NA19204,1226733,49682,104301,1380716,153983,67.7354,32.2646
HG00737,1262833,34991,82892,1380716,117883,70.3172,29.6828
NA18597,1278404,48460,53852,1380716,102312,52.6351,47.3649
NA19352,1277669,103047,0,1380716,103047,0.0,100.0
NA20535,1280923,39813,59980,1380716,99793,60.1044,39.8956
NA19003,1276829,50415,53472,1380716,103887,51.4713,48.5287
NA18867,1226689,53611,100416,1380716,154027,65.1938,34.8062
NA18535,1276637,45485,58594,1380716,104079,56.2976,43.7024
NA12812,1307998,72718,0,1380716,72718,0.0,100.0
NA18489,1225842,53209,101665,1380716,154874,65.6437,34.3563
NA20768,1276738,43591,60387,1380716,103978,58.0767,41.9233
NA19315,1227380,49662,103674,1380716,153336,67.6123,32.3877
HG01342,1241971,38114,100631,1380716,138745,72.5295,27.4705
NA19380,1278355,102361,0,1380716,102361,0.0,100.0
NA19138,1280330,100386,0,1380716,100386,0.0,100.0
HG00285,1280016,42065,58635,1380716,100700,58.2274,41.7726
HG00559,1306020,74696,0,1380716,74696,0.0,100.0
NA19753,1307452,73264,0,1380716,73264,0.0,100.0
HG01271,1305855,74861,0,1380716,74861,0.0,100.0
HG00407,1274960,45903,59853,1380716,105756,56.5954,43.4046
NA20813,1279388,40724,60604,1380716,101328,59.8097,40.1903
HG00581,1274641,44840,61235,1380716,106075,57.728,42.272
NA19431,1223761,50940,106015,1380716,156955,67.5448,32.4552
HG01083,1267634,42854,70228,1380716,113082,62.1036,37.8964
HG01108,1231296,47877,101543,1380716,149420,67.9581,32.0419
NA18635,1307000,73716,0,1380716,73716,0.0,100.0
HG00534,1276785,49175,54756,1380716,103931,52.685,47.315
NA12144,1306725,73991,0,1380716,73991,0.0,100.0
NA19393,1278649,102067,0,1380716,102067,0.0,100.0
NA18637,1306236,74480,0,1380716,74480,0.0,100.0
NA12716,1308970,71746,0,1380716,71746,0.0,100.0
HG00262,1282460,41727,56529,1380716,98256,57.5324,42.4676
HG00428,1280027,47452,53237,1380716,100689,52.8727,47.1273
NA20519,1308245,72471,0,1380716,72471,0.0,100.0
HG00179,1278394,41710,60612,1380716,102322,59.2365,40.7635
HG01465,1280197,45085,55434,1380716,100519,55.1478,44.8522
HG01095,1263666,40158,76892,1380716,117050,65.6916,34.3084
NA18642,1278496,45033,57187,1380716,102220,55.945,44.055
HG00116,1307367,73349,0,1380716,73349,0.0,100.0
NA20527,1310606,70110,0,1380716,70110,0.0,100.0
HG01440,1295079,85637,0,1380716,85637,0.0,100.0
NA18939,1279316,47267,54133,1380716,101400,53.3856,46.6144
HG00346,1277837,41756,61123,1380716,102879,59.4125,40.5875
NA18977,1305617,75099,0,1380716,75099,0.0,100.0
HG01275,1276376,36876,67464,1380716,104340,64.6578,35.3422
NA18981,1279126,48526,53064,1380716,101590,52.2335,47.7665
NA19036,1229525,52044,99147,1380716,151191,65.5773,34.4227
NA20800,1278838,44336,57542,1380716,101878,56.4813,43.5187
NA19657,1270593,43574,66549,1380716,110123,60.4315,39.5685
NA19108,1229374,51405,99937,1380716,151342,66.0339,33.9661
NA18953,1307625,73091,0,1380716,73091,0.0,100.0
HG00109,1310622,70094,0,1380716,70094,0.0,100.0
HG00699,1276362,49616,54738,1380716,104354,52.4541,47.5459
HG00530,1307047,73669,0,1380716,73669,0.0,100.0
HG00112,1309751,70965,0,1380716,70965,0.0,100.0
HG00325,1310173,70543,0,1380716,70543,0.0,100.0
HG00608,1276601,46730,57385,1380716,104115,55.1169,44.8831
NA18620,1304870,75846,0,1380716,75846,0.0,100.0
NA19121,1282550,98166,0,1380716,98166,0.0,100.0
NA20772,1276275,38543,65898,1380716,104441,63.0959,36.9041
HG00353,1278765,39191,62760,1380716,101951,61.559,38.441
HG00620,1275884,46333,58499,1380716,104832,55.8026,44.1974
HG01515,1304521,76195,0,1380716,76195,0.0,100.0
HG00149,1305841,74875,0,1380716,74875,0.0,100.0
NA12718,1273220,42168,65328,1380716,107496,60.7725,39.2275
NA19058,1306225,74491,0,1380716,74491,0.0,100.0
HG01623,1277724,37414,65578,1380716,102992,63.6729,36.3271
NA12347,1312158,68558,0,1380716,68558,0.0,100.0
HG00698,1302504,78212,0,1380716,78212,0.0,100.0
NA18641,1280280,46943,53493,1380716,100436,53.2608,46.7392
NA19776,1273965,41560,65191,1380716,106751,61.0683,38.9317
NA19818,1286129,94587,0,1380716,94587,0.0,100.0
HG00619,1304553,76163,0,1380716,76163,0.0,100.0
NA19717,1303676,77040,0,1380716,77040,0.0,100.0
HG00478,1306877,73839,0,1380716,73839,0.0,100.0
HG01494,1307516,73200,0,1380716,73200,0.0,100.0
NA18749,1307042,73674,0,1380716,73674,0.0,100.0
NA19437,1227457,48475,104784,1380716,153259,68.3705,31.6295
NA18570,1278259,46936,55521,1380716,102457,54.1896,45.8104
NA20752,1310401,70315,0,1380716,70315,0.0,100.0
NA20755,1309114,71602,0,1380716,71602,0.0,100.0
NA19076,1307285,73431,0,1380716,73431,0.0,100.0
NA12873,1275686,41248,63782,1380716,105030,60.7274,39.2726
NA19756,1303054,77662,0,1380716,77662,0.0,100.0
HG00237,1279199,40561,60956,1380716,101517,60.0451,39.9549
HG01550,1307971,72745,0,1380716,72745,0.0,100.0
HG00442,1305779,74937,0,1380716,74937,0.0,100.0
NA18963,1278536,48206,53974,1380716,102180,52.8225,47.1775
NA19248,1278401,102315,0,1380716,102315,0.0,100.0
NA18552,1279823,49526,51367,1380716,100893,50.9124,49.0876
NA19923,1243472,37797,99447,1380716,137244,72.46,27.54
NA19439,1233748,54065,92903,1380716,146968,63.2131,36.7869
NA19774,1308997,71719,0,1380716,71719,0.0,100.0
NA20806,1307123,73593,0,1380716,73593,0.0,100.0
NA20753,1275226,42100,63390,1380716,105490,60.091,39.909
NA12546,1308532,72184,0,1380716,72184,0.0,100.0
HG00366,1311481,69235,0,1380716,69235,0.0,100.0
HG00178,1279923,40849,59944,1380716,100793,59.4724,40.5276
NA19327,1225507,52748,102461,1380716,155209,66.0149,33.9851
NA07037,1276518,38980,65218,1380716,104198,62.5905,37.4095
HG00422,1280254,49182,51280,1380716,100462,51.0442,48.9558
NA19700,1277990,102726,0,1380716,102726,0.0,100.0
NA18571,1278397,47573,54746,1380716,102319,53.5052,46.4948
NA19908,1280136,100580,0,1380716,100580,0.0,100.0
NA20531,1275901,40616,64199,1380716,104815,61.2498,38.7502
NA12058,1274133,41238,65345,1380716,106583,61.309,38.691
HG01149,1276746,43475,60495,1380716,103970,58.1851,41.8149
NA20359,1240823,41582,98311,1380716,139893,70.2759,29.7241
HG01073,1271477,41159,68080,1380716,109239,62.3221,37.6779
HG00108,1308202,72514,0,1380716,72514,0.0,100.0
HG00377,1278893,43762,58061,1380716,101823,57.0215,42.9785
NA20533,1288981,48838,42897,1380716,91735,46.7619,53.2381
NA11893,1307420,73296,0,1380716,73296,0.0,100.0
NA19660,1272544,42622,65550,1380716,108172,60.5979,39.4021
HG00263,1277951,40749,62016,1380716,102765,60.3474,39.6526
HG01492,1267758,38042,74916,1380716,112958,66.322,33.678
HG00596,1277027,47322,56367,1380716,103689,54.3616,45.6384
NA07051,1308713,72003,0,1380716,72003,0.0,100.0
NA12283,1277528,40278,62910,1380716,103188,60.9664,39.0336
NA12874,1309703,71013,0,1380716,71013,0.0,100.0
HG00275,1275312,42039,63365,1380716,105404,60.1163,39.8837
NA12249,1279861,42052,58803,1380716,100855,58.3045,41.6955
HG01112,1307251,73465,0,1380716,73465,0.0,100.0
NA18616,1274204,49844,56668,1380716,106512,53.2034,46.7966
NA11930,1310470,70246,0,1380716,70246,0.0,100.0
HG00117,1309086,71630,0,1380716,71630,0.0,100.0
HG00637,1304942,75774,0,1380716,75774,0.0,100.0
NA12489,1279861,38345,62510,1380716,100855,61.9801,38.0199
NA18530,1305465,75251,0,1380716,75251,0.0,100.0
HG00554,1278067,46332,56317,1380716,102649,54.8637,45.1363
NA19759,1303209,77507,0,1380716,77507,0.0,100.0
HG01272,1271752,48546,60418,1380716,108964,55.4477,44.5523
HG00313,1279818,44152,56746,1380716,100898,56.241,43.759
HG00309,1276680,43494,60542,1380716,104036,58.1933,41.8067
HG01104,1304634,76082,0,1380716,76082,0.0,100.0
HG00339,1279197,40530,60989,1380716,101519,60.0764,39.9236
NA18499,1225735,52639,102342,1380716,154981,66.0352,33.9648
HG00654,1276790,46947,56979,1380716,103926,54.8265,45.1735
NA19065,1275581,46222,58913,1380716,105135,56.0356,43.9644
HG00152,1308466,72250,0,1380716,72250,0.0,100.0
NA20783,1309587,71129,0,1380716,71129,0.0,100.0
HG01204,1304804,75912,0,1380716,75912,0.0,100.0
NA19116,1226524,54931,99261,1380716,154192,64.3749,35.6251
NA11843,1305701,75015,0,1380716,75015,0.0,100.0
NA19758,1270753,43030,66933,1380716,109963,60.8687,39.1313
HG01098,1273584,38872,68260,1380716,107132,63.7158,36.2842
HG00250,1277013,42706,60997,1380716,103703,58.8189,41.1811
NA20819,1273744,40435,66537,1380716,106972,62.2004,37.7996
HG00312,1307790,72926,0,1380716,72926,0.0,100.0
NA20798,1309546,71170,0,1380716,71170,0.0,100.0
NA18868,1280831,99885,0,1380716,99885,0.0,100.0
HG00589,1304219,76497,0,1380716,76497,0.0,100.0
HG00359,1278244,39597,62875,1380716,102472,61.3582,38.6418
NA06994,1310150,70566,0,1380716,70566,0.0,100.0
HG00255,1275563,41045,64108,1380716,105153,60.9664,39.0336
HG00330,1277448,41810,61458,1380716,103268,59.5131,40.4869
NA19137,1228710,52911,99095,1380716,152006,65.1915,34.8085
NA20812,1308266,72450,0,1380716,72450,0.0,100.0
NA18522,1280268,100448,0,1380716,100448,0.0,100.0
NA11931,1278798,39544,62374,1380716,101918,61.2002,38.7998
HG00358,1311110,69606,0,1380716,69606,0.0,100.0
NA19725,1273045,38492,69179,1380716,107671,64.2504,35.7496
NA18609,1307453,73263,0,1380716,73263,0.0,100.0
NA19782,1277093,45509,58114,1380716,103623,56.0821,43.9179
NA19462,1227240,50006,103470,1380716,153476,67.4177,32.5823
HG00524,1303770,76946,0,1380716,76946,0.0,100.0
NA19473,1230775,50430,99511,1380716,149941,66.3668,33.6332
HG01125,1274985,39737,65994,1380716,105731,62.4169,37.5831
NA12004,1275019,38887,66810,1380716,105697,63.209,36.791
HG00119,1306677,74039,0,1380716,74039,0.0,100.0
NA20760,1276432,42253,62031,1380716,104284,59.4828,40.5172
NA18516,1278089,102627,0,1380716,102627,0.0,100.0
NA12275,1271652,38746,70318,1380716,109064,64.4741,35.5259
NA18595,1278667,46076,55973,1380716,102049,54.8491,45.1509
NA20341,1224647,46999,109070,1380716,156069,69.8858,30.1142
NA19461,1279650,101066,0,1380716,101066,0.0,100.0
NA19399,1227400,52625,100691,1380716,153316,65.6755,34.3245
NA20336,1233297,45839,101580,1380716,147419,68.9056,31.0944
NA20754,1310684,70032,0,1380716,70032,0.0,100.0
NA19719,1268996,43068,68652,1380716,111720,61.4501,38.5499
HG00458,1277254,47004,56458,1380716,103462,54.5688,45.4312
NA20412,1228072,48022,104622,1380716,152644,68.5399,31.4601
NA20797,1278687,40030,61999,1380716,102029,60.7661,39.2339
NA12829,1306311,74405,0,1380716,74405,0.0,100.0
NA20515,1309802,70914,0,1380716,70914,0.0,100.0
NA18645,1305121,75595,0,1380716,75595,0.0,100.0
NA12348,1278098,43723,58895,1380716,102618,57.3925,42.6075
NA19452,1287129,93587,0,1380716,93587,0.0,100.0
HG01055,1269275,39594,71847,1380716,111441,64.4709,35.5291
NA19711,1283389,97327,0,1380716,97327,0.0,100.0
NA19720,1305124,75592,0,1380716,75592,0.0,100.0
HG00651,1278161,48269,54286,1380716,102555,52.9335,47.0665
HG01344,1308647,72069,0,1380716,72069,0.0,100.0
HG01080,1263977,39513,77226,1380716,116739,66.1527,33.8473
NA20508,1277893,39243,63580,1380716,102823,61.8344,38.1656
NA19466,1286381,94335,0,1380716,94335,0.0,100.0
HG00100,1280344,44706,55666,1380716,100372,55.4597,44.5403
HG00613,1305754,74962,0,1380716,74962,0.0,100.0
NA18592,1280522,48291,51903,1380716,100194,51.8025,48.1975
HG01048,1307965,72751,0,1380716,72751,0.0,100.0
NA19819,1227517,52025,101174,1380716,153199,66.0409,33.9591
NA18871,1277517,103199,0,1380716,103199,0.0,100.0
NA19404,1225326,52233,103157,1380716,155390,66.3859,33.6141
HG00260,1308899,71817,0,1380716,71817,0.0,100.0
NA20340,1279081,101635,0,1380716,101635,0.0,100.0
NA19712,1229068,47066,104582,1380716,151648,68.9637,31.0363
NA20322,1225731,49924,105061,1380716,154985,67.7879,32.2121
NA19430,1276972,103744,0,1380716,103744,0.0,100.0
HG00126,1309117,71599,0,1380716,71599,0.0,100.0
NA20334,1234018,45770,100928,1380716,146698,68.7998,31.2002
NA19088,1306477,74239,0,1380716,74239,0.0,100.0
NA19762,1302323,78393,0,1380716,78393,0.0,100.0
HG01378,1274030,42433,64253,1380716,106686,60.2263,39.7737
NA19755,1270428,45180,65108,1380716,110288,59.0345,40.9655
HG00427,1306174,74542,0,1380716,74542,0.0,100.0
HG00236,1274181,40750,65785,1380716,106535,61.7497,38.2503
NA18523,1225988,53410,101318,1380716,154728,65.4814,34.5186
NA19102,1224030,53335,103351,1380716,156686,65.9606,34.0394
NA19390,1221143,47935,111638,1380716,159573,69.9605,30.0395
NA19391,1225049,53761,101906,1380716,155667,65.4641,34.5359
NA18559,1306815,73901,0,1380716,73901,0.0,100.0
NA20538,1308448,72268,0,1380716,72268,0.0,100.0
HG00452,1279648,48309,52759,1380716,101068,52.2015,47.7985
NA19072,1305724,74992,0,1380716,74992,0.0,100.0
HG00684,1274337,46734,59645,1380716,106379,56.0684,43.9316
NA19375,1278353,102363,0,1380716,102363,0.0,100.0
HG01359,1309711,71005,0,1380716,71005,0.0,100.0
HG01061,1270300,42043,68373,1380716,110416,61.9231,38.0769
NA12843,1276116,38740,65860,1380716,104600,62.9637,37.0363
HG01197,1304097,76619,0,1380716,76619,0.0,100.0
HG01136,1298575,82141,0,1380716,82141,0.0,100.0
HG01107,1305433,75283,0,1380716,75283,0.0,100.0
HG00326,1277191,44760,58765,1380716,103525,56.7641,43.2359
NA20773,1275978,40211,64527,1380716,104738,61.608,38.392
NA19914,1236380,47276,97060,1380716,144336,67.2459,32.7541
HG01278,1277626,43052,60038,1380716,103090,58.2384,41.7616
NA18995,1309265,71451,0,1380716,71451,0.0,100.0
NA20792,1309897,70819,0,1380716,70819,0.0,100.0
NA19779,1271479,40705,68532,1380716,109237,62.737,37.263
HG01257,1273991,41727,64998,1380716,106725,60.9023,39.0977
NA18548,1306307,74409,0,1380716,74409,0.0,100.0
NA18950,1275070,47990,57656,1380716,105646,54.5747,45.4253
HG01124,1305445,75271,0,1380716,75271,0.0,100.0
NA19909,1236692,49641,94383,1380716,144024,65.5328,34.4672
HG00663,1280368,50222,50126,1380716,100348,49.9522,50.0478
HG00318,1275384,41449,63883,1380716,105332,60.6492,39.3508
NA12778,1275069,41234,64413,1380716,105647,60.97,39.03
NA19783,1307712,73004,0,1380716,73004,0.0,100.0
HG00473,1276504,48814,55398,1380716,104212,53.1589,46.8411
NA18561,1302567,78149,0,1380716,78149,0.0,100.0
NA11919,1307868,72848,0,1380716,72848,0.0,100.0
HG00740,1268465,40685,71566,1380716,112251,63.7553,36.2447
NA19443,1279746,100970,0,1380716,100970,0.0,100.0
NA18602,1277323,47926,55467,1380716,103393,53.6468,46.3532
NA19747,1306227,74489,0,1380716,74489,0.0,100.0
HG00373,1277673,40936,62107,1380716,103043,60.2729,39.7271
HG00367,1277218,41072,62426,1380716,103498,60.3161,39.6839
NA19080,1277230,48359,55127,1380716,103486,53.27,46.73
NA19737,1276629,41242,62845,1380716,104087,60.3774,39.6226
HG00672,1278900,48884,52932,1380716,101816,51.9879,48.0121
HG00280,1305526,75190,0,1380716,75190,0.0,100.0
HG00176,1271626,41792,67298,1380716,109090,61.6903,38.3097
HG00580,1304372,76344,0,1380716,76344,0.0,100.0
NA19059,1276593,48234,55889,1380716,104123,53.6759,46.3241
NA18934,1276275,104441,0,1380716,104441,0.0,100.0
NA12341,1275681,40918,64117,1380716,105035,61.0435,38.9565
HG00443,1276736,48394,55586,1380716,103980,53.4584,46.5416
HG00269,1277697,42557,60462,1380716,103019,58.6901,41.3099
HG00375,1308884,71832,0,1380716,71832,0.0,100.0
NA18573,1281021,45864,53831,1380716,99695,53.9957,46.0043
HG01357,1275947,43226,61543,1380716,104769,58.7416,41.2584
HG00350,1280576,40605,59535,1380716,100140,59.4518,40.5482
HG00320,1274682,40510,65524,1380716,106034,61.7953,38.2047
NA19311,1278558,102158,0,1380716,102158,0.0,100.0
NA19684,1273777,40812,66127,1380716,106939,61.8362,38.1638
HG00542,1306268,74448,0,1380716,74448,0.0,100.0
NA20799,1278661,38778,63277,1380716,102055,62.0028,37.9972
HG00274,1276603,42614,61499,1380716,104113,59.0695,40.9305
HG00437,1276947,48602,55167,1380716,103769,53.1633,46.8367
NA19247,1230109,52705,97902,1380716,150607,65.0049,34.9951
NA19095,1226422,48655,105639,1380716,154294,68.466,31.534
HG01350,1308516,72200,0,1380716,72200,0.0,100.0
NA18873,1225641,51706,103369,1380716,155075,66.6574,33.3426
HG00640,1301547,79169,0,1380716,79169,0.0,100.0
HG01171,1251473,37421,91822,1380716,129243,71.046,28.954
NA18560,1275698,45844,59174,1380716,105018,56.3465,43.6535
HG00335,1309155,71561,0,1380716,71561,0.0,100.0
NA18976,1278369,48398,53949,1380716,102347,52.7119,47.2881
HG00239,1277470,39496,63750,1380716,103246,61.7457,38.2543
NA19066,1305997,74719,0,1380716,74719,0.0,100.0
HG00533,1303471,77245,0,1380716,77245,0.0,100.0
HG01134,1273397,43421,63898,1380716,107319,59.5402,40.4598
HG00457,1305138,75578,0,1380716,75578,0.0,100.0
NA19130,1274332,106384,0,1380716,106384,0.0,100.0
NA19350,1280049,100667,0,1380716,100667,0.0,100.0
HG00351,1309103,71613,0,1380716,71613,0.0,100.0
NA20505,1276486,38417,65813,1380716,104230,63.1421,36.8579
NA12872,1310048,70668,0,1380716,70668,0.0,100.0
HG00584,1278755,45946,56015,1380716,101961,54.9377,45.0623
NA19685,1305596,75120,0,1380716,75120,0.0,100.0
HG01052,1236679,41428,102609,1380716,144037,71.2379,28.7621
NA18557,1307344,73372,0,1380716,73372,0.0,100.0
HG00381,1279998,39309,61409,1380716,100718,60.9712,39.0288
NA18615,1278572,47576,54568,1380716,102144,53.4226,46.5774
NA18528,1281373,47979,51364,1380716,99343,51.7037,48.2963
HG01274,1306846,73870,0,1380716,73870,0.0,100.0
NA18960,1304035,76681,0,1380716,76681,0.0,100.0
NA18582,1279749,46764,54203,1380716,100967,53.6839,46.3161
NA18566,1276148,46680,57888,1380716,104568,55.3592,44.6408
HG00146,1275253,41499,63964,1380716,105463,60.6507,39.3493
NA19185,1228219,51804,100693,1380716,152497,66.0295,33.9705
NA20524,1308951,71765,0,1380716,71765,0.0,100.0
NA19098,1279379,101337,0,1380716,101337,0.0,100.0
HG01174,1270099,41144,69473,1380716,110617,62.805,37.195
HG01461,1301813,78903,0,1380716,78903,0.0,100.0
NA19057,1277753,48062,54901,1380716,102963,53.3211,46.6789
NA19383,1280948,99768,0,1380716,99768,0.0,100.0
NA12749,1277741,40512,62463,1380716,102975,60.6584,39.3416
NA18947,1273076,46187,61453,1380716,107640,57.0912,42.9088
HG00264,1310034,70682,0,1380716,70682,0.0,100.0
NA19351,1226961,52269,101486,1380716,153755,66.005,33.995
NA19735,1309245,71471,0,1380716,71471,0.0,100.0
NA20506,1304389,64389,11938,1380716,76327,15.6406,84.3594
HG01102,1270452,44012,66252,1380716,110264,60.0849,39.9151
NA19360,1274390,106326,0,1380716,106326,0.0,100.0
NA18623,1305779,74937,0,1380716,74937,0.0,100.0
HG01168,1274926,37662,68128,1380716,105790,64.3993,35.6007
HG00355,1278757,40770,61189,1380716,101959,60.0133,39.9867
NA20289,1224813,48101,107802,1380716,155903,69.1468,30.8532
HG00281,1276736,42186,61794,1380716,103980,59.4287,40.5713
NA20346,1282441,98275,0,1380716,98275,0.0,100.0
NA19703,1277893,102823,0,1380716,102823,0.0,100.0
NA19789,1304323,76393,0,1380716,76393,0.0,100.0
HG01251,1268025,40101,72590,1380716,112691,64.4151,35.5849
HG00376,1276885,39974,63857,1380716,103831,61.5009,38.4991
HG00183,1307046,73670,0,1380716,73670,0.0,100.0
NA19074,1275352,48515,56849,1380716,105364,53.9549,46.0451
NA20517,1277120,40504,63092,1380716,103596,60.902,39.098
NA19004,1304428,76288,0,1380716,76288,0.0,100.0
HG01389,1305078,75638,0,1380716,75638,0.0,100.0
HG01072,1304288,76428,0,1380716,76428,0.0,100.0
HG01366,1246378,41308,93030,1380716,134338,69.2507,30.7493
NA19041,1282077,98639,0,1380716,98639,0.0,100.0
HG01462,1264818,44471,71427,1380716,115898,61.6292,38.3708
NA18532,1276772,48139,55805,1380716,103944,53.6876,46.3124
NA18567,1277023,48186,55507,1380716,103693,53.5301,46.4699
NA18861,1232455,52335,95926,1380716,148261,64.7008,35.2992
NA18965,1305084,75632,0,1380716,75632,0.0,100.0
NA19723,1304553,76163,0,1380716,76163,0.0,100.0
NA18985,1303665,77051,0,1380716,77051,0.0,100.0
NA19985,1234084,40547,106085,1380716,146632,72.3478,27.6522
NA18638,1306330,74386,0,1380716,74386,0.0,100.0
HG00232,1277350,40110,63256,1380716,103366,61.1961,38.8039
HG00233,1276633,44602,59481,1380716,104083,57.1477,42.8523
HG00690,1277494,48217,55005,1380716,103222,53.2881,46.7119
HG01551,1249375,40189,91152,1380716,131341,69.401,30.599
HG00369,1306574,74142,0,1380716,74142,0.0,100.0
NA18988,1306484,74232,0,1380716,74232,0.0,100.0
NA20542,1276874,41902,61940,1380716,103842,59.6483,40.3517
NA19146,1278891,101825,0,1380716,101825,0.0,100.0
NA19777,1302008,78708,0,1380716,78708,0.0,100.0
HG01334,1308636,72080,0,1380716,72080,0.0,100.0
NA07347,1308657,72059,0,1380716,72059,0.0,100.0
NA20532,1308789,71927,0,1380716,71927,0.0,100.0
NA18952,1306242,74474,0,1380716,74474,0.0,100.0
NA19746,1249992,39856,90868,1380716,130724,69.5113,30.4887
NA18505,1228271,50561,101884,1380716,152445,66.8333,33.1667
NA18545,1275998,48209,56509,1380716,104718,53.963,46.037
HG01519,1279949,41560,59207,1380716,100767,58.7563,41.2437
HG01353,1302780,77936,0,1380716,77936,0.0,100.0
NA20536,1309006,71710,0,1380716,71710,0.0,100.0
NA20502,1276440,41939,62337,1380716,104276,59.7808,40.2192
NA12003,1311901,68815,0,1380716,68815,0.0,100.0
HG00278,1310101,70615,0,1380716,70615,0.0,100.0
NA18957,1279419,47078,54219,1380716,101297,53.5248,46.4752
NA20522,1277000,42223,61493,1380716,103716,59.2898,40.7102
NA19075,1305795,74921,0,1380716,74921,0.0,100.0
NA18508,1230516,53717,96483,1380716,150200,64.2364,35.7636
HG00097,1278140,41096,61480,1380716,102576,59.936,40.064
HG00657,1277026,47254,56436,1380716,103690,54.4276,45.5724
NA20795,1278891,41314,60511,1380716,101825,59.4265,40.5735
NA18539,1278683,48212,53821,1380716,102033,52.7486,47.2514
NA19900,1278909,101807,0,1380716,101807,0.0,100.0
NA18553,1277204,48362,55150,1380716,103512,53.2788,46.7212
NA19469,1222228,51520,106968,1380716,158488,67.4928,32.5072
NA18975,1274892,45466,60358,1380716,105824,57.0362,42.9638
NA20589,1275720,41527,63469,1380716,104996,60.449,39.551
NA20342,1279065,101651,0,1380716,101651,0.0,100.0
NA18517,1226625,51535,102556,1380716,154091,66.5555,33.4445
HG01488,1308406,72310,0,1380716,72310,0.0,100.0
HG00734,1255504,39330,85882,1380716,125212,68.5893,31.4107
NA18999,1276844,48595,55277,1380716,103872,53.2165,46.7835
NA11995,1277099,40977,62640,1380716,103617,60.4534,39.5466
NA19067,1306002,74714,0,1380716,74714,0.0,100.0
NA18990,1303342,77374,0,1380716,77374,0.0,100.0
NA19063,1304466,76250,0,1380716,76250,0.0,100.0
NA10847,1278003,41828,60885,1380716,102713,59.2768,40.7232
NA18908,1277409,103307,0,1380716,103307,0.0,100.0
HG01626,1276242,38280,66194,1380716,104474,63.3593,36.6407
NA18748,1310090,70626,0,1380716,70626,0.0,100.0
NA19257,1231626,51525,97565,1380716,149090,65.4403,34.5597
NA19738,1306239,74477,0,1380716,74477,0.0,100.0
HG00311,1310785,69931,0,1380716,69931,0.0,100.0
HG00135,1279455,38806,62455,1380716,101261,61.6772,38.3228
HG00244,1309534,71182,0,1380716,71182,0.0,100.0
NA19672,1272558,38015,70143,1380716,108158,64.8523,35.1477
HG00245,1278243,41306,61167,1380716,102473,59.6908,40.3092
NA18510,1282408,98308,0,1380716,98308,0.0,100.0
NA12046,1279863,40589,60264,1380716,100853,59.7543,40.2457
NA19038,1225031,48769,106916,1380716,155685,68.6746,31.3254
HG01079,1299847,80869,0,1380716,80869,0.0,100.0
HG00736,1310028,70688,0,1380716,70688,0.0,100.0
NA19222,1227672,51659,101385,1380716,153044,66.2457,33.7543
HG00445,1307183,73533,0,1380716,73533,0.0,100.0
NA19046,1279876,100840,0,1380716,100840,0.0,100.0
NA19449,1229667,49109,101940,1380716,151049,67.488,32.512
NA12775,1311154,69562,0,1380716,69562,0.0,100.0
NA19661,1306322,74394,0,1380716,74394,0.0,100.0
NA19060,1305806,74910,0,1380716,74910,0.0,100.0
HG00607,1306242,74474,0,1380716,74474,0.0,100.0
HG00310,1307830,72886,0,1380716,72886,0.0,100.0
NA19675,1270123,40000,70593,1380716,110593,63.8313,36.1687
NA18912,1227588,53553,99575,1380716,153128,65.0273,34.9727
HG00610,1304979,75737,0,1380716,75737,0.0,100.0
HG00186,1307904,72812,0,1380716,72812,0.0,100.0
NA19256,1280551,100165,0,1380716,100165,0.0,100.0
NA20816,1310147,70569,0,1380716,70569,0.0,100.0
NA12282,1309345,71371,0,1380716,71371,0.0,100.0
HG00101,1313231,67485,0,1380716,67485,0.0,100.0
NA19085,1303005,77711,0,1380716,77711,0.0,100.0
NA19223,1273461,107255,0,1380716,107255,0.0,100.0
HG00500,1305721,74995,0,1380716,74995,0.0,100.0
NA12842,1309359,71357,0,1380716,71357,0.0,100.0
NA18978,1279746,42847,58123,1380716,100970,57.5646,42.4354
NA19794,1271008,39991,69717,1380716,109708,63.5478,36.4522
HG00383,1280429,40532,59755,1380716,100287,59.584,40.416
NA18971,1306817,73899,0,1380716,73899,0.0,100.0
HG00732,1275946,44168,60602,1380716,104770,57.8429,42.1571
NA19319,1277404,103312,0,1380716,103312,0.0,100.0
HG00327,1274336,42908,63472,1380716,106380,59.6654,40.3346
NA12827,1307243,73473,0,1380716,73473,0.0,100.0
NA18944,1306592,74124,0,1380716,74124,0.0,100.0
NA20765,1309301,71415,0,1380716,71415,0.0,100.0
HG00566,1279118,49504,52094,1380716,101598,51.2746,48.7254
NA19398,1224558,52409,103749,1380716,156158,66.4385,33.5615
HG01356,1305918,74798,0,1380716,74798,0.0,100.0
NA19451,1278846,101870,0,1380716,101870,0.0,100.0
NA19209,1226570,52704,101442,1380716,154146,65.809,34.191
HG00404,1276227,46382,58107,1380716,104489,55.6106,44.3894
HG01176,1297350,83366,0,1380716,83366,0.0,100.0
NA19916,1277334,103382,0,1380716,103382,0.0,100.0
NA18558,1305383,75333,0,1380716,75333,0.0,100.0
NA19457,1228986,49741,101989,1380716,151730,67.2174,32.7826
HG00122,1280424,41721,58571,1380716,100292,58.4005,41.5995
HG00731,1308170,72546,0,1380716,72546,0.0,100.0
NA18961,1306541,74175,0,1380716,74175,0.0,100.0
NA19749,1272236,45191,63289,1380716,108480,58.3416,41.6584
NA18550,1277695,48778,54243,1380716,103021,52.6524,47.3476
NA18605,1303837,76879,0,1380716,76879,0.0,100.0
NA19129,1227515,50751,102450,1380716,153201,66.8729,33.1271
HG00123,1276524,40475,63717,1380716,104192,61.1534,38.8466
NA20588,1308796,71920,0,1380716,71920,0.0,100.0
NA18627,1279334,48612,52770,1380716,101382,52.0507,47.9493
HG00449,1278288,47449,54979,1380716,102428,53.6758,46.3242
NA18745,1306507,74209,0,1380716,74209,0.0,100.0
NA18647,1309115,71601,0,1380716,71601,0.0,100.0
HG01277,1307924,72792,0,1380716,72792,0.0,100.0
NA19207,1275003,105713,0,1380716,105713,0.0,100.0
NA19310,1232459,49046,99211,1380716,148257,66.9183,33.0817
NA19324,1224495,52891,103330,1380716,156221,66.1435,33.8565
HG00171,1277571,40758,62387,1380716,103145,60.4848,39.5152
HG00099,1276183,42315,62218,1380716,104533,59.52,40.48
NA18968,1282803,49944,47969,1380716,97913,48.9915,51.0085
NA12045,1309263,71453,0,1380716,71453,0.0,100.0
NA06986,1307960,72756,0,1380716,72756,0.0,100.0
NA18486,1277920,102796,0,1380716,102796,0.0,100.0
HG00378,1277401,40846,62469,1380716,103315,60.4646,39.5354
NA19921,1228581,50144,101991,1380716,152135,67.0398,32.9602
HG00557,1277390,45868,57458,1380716,103326,55.6085,44.3915
NA19331,1276323,104393,0,1380716,104393,0.0,100.0
NA18527,1277710,44540,58466,1380716,103006,56.7598,43.2402
NA19436,1226268,48793,105655,1380716,154448,68.4081,31.5919
HG00111,1275799,38710,66207,1380716,104917,63.1042,36.8958
HG01375,1270612,38742,71362,1380716,110104,64.8133,35.1867
NA18974,1305173,75543,0,1380716,75543,0.0,100.0
HG00625,1303506,77210,0,1380716,77210,0.0,100.0
NA19716,1276497,46218,58001,1380716,104219,55.653,44.347
HG00180,1280898,43979,55839,1380716,99818,55.9408,44.0592
NA18973,1281211,46753,52752,1380716,99505,53.0144,46.9856
HG00592,1307359,73357,0,1380716,73357,0.0,100.0
NA19338,1226496,48352,105868,1380716,154220,68.6474,31.3526
NA18619,1276166,45245,59305,1380716,104550,56.7241,43.2759
NA18596,1280866,47573,52277,1380716,99850,52.3555,47.6445
NA06989,1275708,40558,64450,1380716,105008,61.3763,38.6237
HG00259,1280933,41993,57790,1380716,99783,57.9157,42.0843
HG00692,1304935,75781,0,1380716,75781,0.0,100.0
NA20520,1307137,73579,0,1380716,73579,0.0,100.0
NA18986,1305441,75275,0,1380716,75275,0.0,100.0
NA19663,1274537,48222,57957,1380716,106179,54.5842,45.4158
HG00273,1307415,73301,0,1380716,73301,0.0,100.0
NA19079,1305422,75294,0,1380716,75294,0.0,100.0
HG00626,1280010,48818,51888,1380716,100706,51.5242,48.4758
HG00323,1274322,40395,65999,1380716,106394,62.0326,37.9674
HG01491,1304853,75863,0,1380716,75863,0.0,100.0
HG00451,1304670,76046,0,1380716,76046,0.0,100.0
NA18579,1277958,46969,55789,1380716,102758,54.2916,45.7084
NA18618,1281153,47343,52220,1380716,99563,52.4492,47.5508
HG00254,1280279,41596,58841,1380716,100437,58.585,41.415
HG01188,1254436,38241,88039,1380716,126280,69.7173,30.2827
NA20544,1308940,71776,0,1380716,71776,0.0,100.0
HG00251,1309162,71554,0,1380716,71554,0.0,100.0
NA19002,1279307,48770,52639,1380716,101409,51.9076,48.0924
NA19434,1229092,51611,100013,1380716,151624,65.9612,34.0388
HG00476,1276803,45883,58030,1380716,103913,55.8448,44.1552
HG01187,1287366,93350,0,1380716,93350,0.0,100.0
HG00319,1274034,41358,65324,1380716,106682,61.2324,38.7676
NA19834,1295104,85612,0,1380716,85612,0.0,100.0
NA20276,1233968,48288,98460,1380716,146748,67.0946,32.9054
HG00436,1305027,75689,0,1380716,75689,0.0,100.0
NA18549,1303328,77388,0,1380716,77388,0.0,100.0
NA19440,1230189,53821,96706,1380716,150527,64.245,35.755
NA19316,1223889,48477,108350,1380716,156827,69.0889,30.9111
NA19397,1282580,98136,0,1380716,98136,0.0,100.0
NA18562,1307450,73266,0,1380716,73266,0.0,100.0
NA20126,1281629,99087,0,1380716,99087,0.0,100.0
HG00331,1277009,41838,61869,1380716,103707,59.6575,40.3425
NA11994,1309822,70894,0,1380716,70894,0.0,100.0
HG00629,1276838,46369,57509,1380716,103878,55.3621,44.6379
NA11932,1307405,73311,0,1380716,73311,0.0,100.0
HG00252,1312350,68366,0,1380716,68366,0.0,100.0
NA12889,1309409,71307,0,1380716,71307,0.0,100.0
NA18945,1306473,74243,0,1380716,74243,0.0,100.0
HG00282,1276847,42973,60896,1380716,103869,58.6277,41.3723
NA20774,1276417,45100,59199,1380716,104299,56.7589,43.2411
HG00139,1310523,70193,0,1380716,70193,0.0,100.0
HG00361,1292315,56610,31791,1380716,88401,35.9623,64.0377
HG01066,1305714,75002,0,1380716,75002,0.0,100.0
NA19682,1302736,77980,0,1380716,77980,0.0,100.0
NA18546,1305911,74805,0,1380716,74805,0.0,100.0
HG01456,1268155,48319,64242,1380716,112561,57.0731,42.9269
NA19785,1272064,44450,64202,1380716,108652,59.0896,40.9104
HG00707,1306977,73739,0,1380716,73739,0.0,100.0
NA20287,1230602,49208,100906,1380716,150114,67.2196,32.7804
NA19200,1276674,104042,0,1380716,104042,0.0,100.0
HG00257,1280936,42943,56837,1380716,99780,56.9623,43.0377
HG00701,1303611,77105,0,1380716,77105,0.0,100.0
NA18951,1277226,45397,58093,1380716,103490,56.1339,43.8661
NA19729,1305520,75196,0,1380716,75196,0.0,100.0
HG01250,1307678,73038,0,1380716,73038,0.0,100.0
HG00671,1306449,74267,0,1380716,74267,0.0,100.0
NA19309,1281921,98795,0,1380716,98795,0.0,100.0
NA18613,1305254,75462,0,1380716,75462,0.0,100.0
HG01148,1305438,75278,0,1380716,75278,0.0,100.0
HG00338,1308461,72255,0,1380716,72255,0.0,100.0
NA19055,1305589,75127,0,1380716,75127,0.0,100.0
NA19118,1230814,49355,100547,1380716,149902,67.0752,32.9248
HG01624,1311405,69311,0,1380716,69311,0.0,100.0
NA19726,1303838,76878,0,1380716,76878,0.0,100.0
HG00182,1307581,73135,0,1380716,73135,0.0,100.0
NA12044,1278084,41500,61132,1380716,102632,59.5643,40.4357
NA19009,1305646,75070,0,1380716,75070,0.0,100.0
NA20299,1240905,37906,101905,1380716,139811,72.8877,27.1123
NA19308,1281615,99101,0,1380716,99101,0.0,100.0
NA19679,1306932,73784,0,1380716,73784,0.0,100.0
HG00472,1305993,74723,0,1380716,74723,0.0,100.0
HG01620,1273105,41182,66429,1380716,107611,61.7307,38.2693
HG01618,1279944,39434,61338,1380716,100772,60.8681,39.1319
NA07357,1306611,74105,0,1380716,74105,0.0,100.0
HG01183,1271394,41697,67625,1380716,109322,61.8585,38.1415
NA19321,1227960,52302,100454,1380716,152756,65.7611,34.2389
NA20525,1307937,72779,0,1380716,72779,0.0,100.0
HG00565,1307415,73301,0,1380716,73301,0.0,100.0
NA19087,1276072,47699,56945,1380716,104644,54.4178,45.5822
HG01085,1304218,76498,0,1380716,76498,0.0,100.0
NA19835,1223295,48769,108652,1380716,157421,69.02,30.98
NA18593,1277896,49559,53261,1380716,102820,51.8002,48.1998
HG00134,1278748,38501,63467,1380716,101968,62.2421,37.7579
HG00590,1276874,45687,58155,1380716,103842,56.0034,43.9966
NA19922,1279611,101105,0,1380716,101105,0.0,100.0
NA20291,1278134,102582,0,1380716,102582,0.0,100.0
HG00156,1306464,74252,0,1380716,74252,0.0,100.0
NA11829,1310409,70307,0,1380716,70307,0.0,100.0
NA18964,1280413,49487,50816,1380716,100303,50.6625,49.3375
NA18949,1275665,48554,56497,1380716,105051,53.7805,46.2195
NA07056,1275879,41323,63514,1380716,104837,60.5836,39.4164
NA19044,1282315,98401,0,1380716,98401,0.0,100.0
NA20317,1227967,45042,107707,1380716,152749,70.5124,29.4876
HG01351,1276877,44368,59471,1380716,103839,57.2723,42.7277
NA18910,1276399,104317,0,1380716,104317,0.0,100.0
NA19651,1274785,42675,63256,1380716,105931,59.7143,40.2857
HG01521,1307136,73580,0,1380716,73580,0.0,100.0
HG00693,1277270,49725,53721,1380716,103446,51.9314,48.0686
NA19332,1276399,95588,8729,1380716,104317,8.3678,91.6322
NA19010,1279276,48179,53261,1380716,101440,52.5049,47.4951
NA19472,1224858,51490,104368,1380716,155858,66.9635,33.0365
NA19114,1225809,52106,102801,1380716,154907,66.363,33.637
NA20761,1277501,40228,62987,1380716,103215,61.025,38.975
NA12814,1310407,70309,0,1380716,70309,0.0,100.0
NA18538,1276031,48128,56557,1380716,104685,54.0259,45.9741
HG00158,1276357,41336,63023,1380716,104359,60.3906,39.6094
NA12340,1311248,69468,0,1380716,69468,0.0,100.0
HG00185,1308461,72255,0,1380716,72255,0.0,100.0
HG01354,1275155,41736,63825,1380716,105561,60.4627,39.5373
NA11831,1309084,71632,0,1380716,71632,0.0,100.0
NA19307,1286513,94203,0,1380716,94203,0.0,100.0
NA19113,1278769,101947,0,1380716,101947,0.0,100.0
NA20586,1307065,73651,0,1380716,73651,0.0,100.0
NA18555,1275510,46257,58949,1380716,105206,56.032,43.968
NA19403,1226038,53368,101310,1380716,154678,65.4974,34.5026
NA19056,1304261,76455,0,1380716,76455,0.0,100.0
NA19732,1304635,76081,0,1380716,76081,0.0,100.0
NA18507,1278155,102561,0,1380716,102561,0.0,100.0
NA19035,1281752,98964,0,1380716,98964,0.0,100.0
HG00124,1276904,42948,60864,1380716,103812,58.6291,41.3709
NA20414,1239596,35763,105357,1380716,141120,74.6577,25.3423
HG00141,1308458,72258,0,1380716,72258,0.0,100.0
HG01384,1269287,38347,73082,1380716,111429,65.5862,34.4138
NA19394,1279368,101348,0,1380716,101348,0.0,100.0
NA19020,1274721,105995,0,1380716,105995,0.0,100.0
NA11992,1312403,68313,0,1380716,68313,0.0,100.0
HG00704,1303923,76793,0,1380716,76793,0.0,100.0
NA19904,1278901,101815,0,1380716,101815,0.0,100.0
NA20758,1309151,71565,0,1380716,71565,0.0,100.0
NA19078,1274177,47578,58961,1380716,106539,55.3422,44.6578
HG00593,1276272,47052,57392,1380716,104444,54.95,45.05
NA18962,1307146,73570,0,1380716,73570,0.0,100.0
NA07000,1276060,37890,66766,1380716,104656,63.7957,36.2043
NA19374,1279477,101239,0,1380716,101239,0.0,100.0
NA20790,1278012,40047,62657,1380716,102704,61.0074,38.9926
HG00267,1308701,72015,0,1380716,72015,0.0,100.0
NA19773,1270426,39405,70885,1380716,110290,64.2715,35.7285
NA20771,1277545,43074,60097,1380716,103171,58.2499,41.7501
NA20521,1309998,70718,0,1380716,70718,0.0,100.0
HG00702,1275167,48036,57513,1380716,105549,54.4894,45.5106
NA20516,1307396,73320,0,1380716,73320,0.0,100.0
HG01140,1271148,44585,64983,1380716,109568,59.3084,40.6916
NA19468,1225117,49590,106009,1380716,155599,68.1296,31.8704
NA19395,1230096,52909,97711,1380716,150620,64.8725,35.1275
HG01070,1269396,47394,63926,1380716,111320,57.4254,42.5746
NA19028,1277365,103351,0,1380716,103351,0.0,100.0
HG00419,1279916,45933,54867,1380716,100800,54.4315,45.5685
HG00131,1306569,74147,0,1380716,74147,0.0,100.0
HG00174,1277540,41326,61850,1380716,103176,59.9461,40.0539
NA18907,1223849,51083,105784,1380716,156867,67.4355,32.5645
HG00151,1308618,72098,0,1380716,72098,0.0,100.0
NA19377,1223725,52115,104876,1380716,156991,66.8038,33.1962
HG01390,1247999,40579,92138,1380716,132717,69.4244,30.5756
NA19648,1278333,44178,58205,1380716,102383,56.8503,43.1497
NA18633,1307501,73215,0,1380716,73215,0.0,100.0
NA19678,1262065,39493,79158,1380716,118651,66.715,33.285
HG00479,1276760,47461,56495,1380716,103956,54.3451,45.6549
HG00155,1310336,70380,0,1380716,70380,0.0,100.0
NA18622,1305458,75258,0,1380716,75258,0.0,100.0
HG00336,1305901,74815,0,1380716,74815,0.0,100.0
HG00364,1280692,37938,62086,1380716,100024,62.0711,37.9289
NA18994,1307863,72853,0,1380716,72853,0.0,100.0
HG00114,1308315,72401,0,1380716,72401,0.0,100.0
NA19172,1226177,51181,103358,1380716,154539,66.8815,33.1185
HG00246,1306199,74517,0,1380716,74517,0.0,100.0
NA19448,1279606,101110,0,1380716,101110,0.0,100.0
HG00238,1280838,36608,63270,1380716,99878,63.3473,36.6527
HG00154,1278351,44346,58019,1380716,102365,56.6786,43.3214
NA18511,1228410,52520,99786,1380716,152306,65.5168,34.4832
NA19385,1278729,101987,0,1380716,101987,0.0,100.0
NA20769,1278902,41919,59895,1380716,101814,58.8279,41.1721
NA19225,1229827,54870,96019,1380716,150889,63.6355,36.3645
NA19000,1305983,74733,0,1380716,74733,0.0,100.0
NA19198,1277048,103668,0,1380716,103668,0.0,100.0
NA18621,1307374,73342,0,1380716,73342,0.0,100.0
NA19171,1275256,105460,0,1380716,105460,0.0,100.0
NA18525,1280370,46816,53530,1380716,100346,53.3454,46.6546
NA18917,1279297,101419,0,1380716,101419,0.0,100.0
NA18572,1307278,73438,0,1380716,73438,0.0,100.0
HG01101,1305030,75686,0,1380716,75686,0.0,100.0
NA20796,1308607,72109,0,1380716,72109,0.0,100.0
NA19471,1224863,50896,104957,1380716,155853,67.3436,32.6564
HG01455,1305996,74720,0,1380716,74720,0.0,100.0
NA19771,1303516,77200,0,1380716,77200,0.0,100.0
NA18542,1278689,46864,55163,1380716,102027,54.0671,45.9329
NA18614,1279791,48041,52884,1380716,100925,52.3993,47.6007
HG00578,1274931,43967,61818,1380716,105785,58.4374,41.5626
NA19189,1279999,100717,0,1380716,100717,0.0,100.0
HG01051,1297666,83050,0,1380716,83050,0.0,100.0
HG00418,1306881,73835,0,1380716,73835,0.0,100.0
NA18941,1279059,47660,53997,1380716,101657,53.1169,46.8831
NA18870,1227046,51230,102440,1380716,153670,66.6623,33.3377
NA18923,1279694,101022,0,1380716,101022,0.0,100.0
HG00406,1305102,75614,0,1380716,75614,0.0,100.0
NA19741,1310890,69826,0,1380716,69826,0.0,100.0
NA19313,1226430,51950,102336,1380716,154286,66.3288,33.6712
NA12777,1309652,71064,0,1380716,71064,0.0,100.0
NA18940,1307245,73471,0,1380716,73471,0.0,100.0
HG00284,1307395,73321,0,1380716,73321,0.0,100.0
NA19384,1275206,105510,0,1380716,105510,0.0,100.0
NA19012,1305925,74791,0,1380716,74791,0.0,100.0
HG00148,1308583,72133,0,1380716,72133,0.0,100.0
HG01167,1293383,87333,0,1380716,87333,0.0,100.0
NA18956,1279095,48493,53128,1380716,101621,52.2805,47.7195
NA20803,1308514,72202,0,1380716,72202,0.0,100.0
NA18534,1302209,78507,0,1380716,78507,0.0,100.0
NA12273,1276023,39828,64865,1380716,104693,61.9573,38.0427
HG01137,1272481,42920,65315,1380716,108235,60.3455,39.6545
NA12272,1307216,73500,0,1380716,73500,0.0,100.0
HG00328,1275821,42717,62178,1380716,104895,59.2764,40.7236
NA18747,1307921,72795,0,1380716,72795,0.0,100.0
HG00270,1276036,42094,62586,1380716,104680,59.7879,40.2121
HG00556,1304227,76489,0,1380716,76489,0.0,100.0
NA19119,1273660,107056,0,1380716,107056,0.0,100.0
HG00121,1283374,40070,57272,1380716,97342,58.8359,41.1641
HG00102,1275295,38855,66566,1380716,105421,63.143,36.857
NA19346,1278305,102411,0,1380716,102411,0.0,100.0
NA20530,1305364,60824,14528,1380716,75352,19.2802,80.7198
NA20534,1306262,74454,0,1380716,74454,0.0,100.0
NA20518,1309115,71601,0,1380716,71601,0.0,100.0
NA18612,1304294,76422,0,1380716,76422,0.0,100.0
NA19096,1279029,101687,0,1380716,101687,0.0,100.0
NA19701,1224181,49298,107237,1380716,156535,68.5067,31.4933
NA19381,1225476,51216,104024,1380716,155240,67.0085,32.9915
NA12830,1277165,39525,64026,1380716,103551,61.8304,38.1696
NA11892,1278783,41891,60042,1380716,101933,58.9034,41.0966
NA20775,1274913,40413,65390,1380716,105803,61.8035,38.1965
NA20344,1234565,48709,97442,1380716,146151,66.6721,33.3279
HG00650,1306324,74392,0,1380716,74392,0.0,100.0
HG00560,1276599,48752,55365,1380716,104117,53.1758,46.8242
NA18632,1306630,74086,0,1380716,74086,0.0,100.0
HG00628,1308124,72592,0,1380716,72592,0.0,100.0
NA19373,1274089,106627,0,1380716,106627,0.0,100.0
NA20786,1275382,42249,63085,1380716,105334,59.8904,40.1096
NA19376,1278846,101870,0,1380716,101870,0.0,100.0
NA19334,1275926,104790,0,1380716,104790,0.0,100.0
NA19082,1305369,75347,0,1380716,75347,0.0,100.0
NA18631,1275151,47213,58352,1380716,105565,55.2759,44.7241
NA18943,1305718,74998,0,1380716,74998,0.0,100.0
HG00349,1277011,37681,66024,1380716,103705,63.6652,36.3348
NA18948,1306222,74494,0,1380716,74494,0.0,100.0
NA20802,1276666,40312,63738,1380716,104050,61.2571,38.7429
HG00329,1307150,73566,0,1380716,73566,0.0,100.0
NA11993,1279224,39800,61692,1380716,101492,60.7851,39.2149
HG00242,1309437,71279,0,1380716,71279,0.0,100.0
HG00277,1310593,70123,0,1380716,70123,0.0,100.0
NA20541,1276266,37572,66878,1380716,104450,64.0287,35.9713
NA19438,1225150,51635,103931,1380716,155566,66.8083,33.1917
NA18989,1307883,72833,0,1380716,72833,0.0,100.0
HG00306,1278043,40128,62545,1380716,102673,60.9167,39.0833
NA06984,1306457,74259,0,1380716,74259,0.0,100.0
NA18983,1304803,75913,0,1380716,75913,0.0,100.0
NA19107,1276589,104127,0,1380716,104127,0.0,100.0
NA11830,1279511,42731,58474,1380716,101205,57.7778,42.2222
NA20539,1309425,71291,0,1380716,71291,0.0,100.0
HG00128,1275889,40061,64766,1380716,104827,61.7837,38.2163
NA19786,1304402,76314,0,1380716,76314,0.0,100.0
NA18856,1281508,99208,0,1380716,99208,0.0,100.0
NA18544,1305381,75335,0,1380716,75335,0.0,100.0
HG01497,1287418,93298,0,1380716,93298,0.0,100.0
NA19355,1225993,48787,105936,1380716,154723,68.4682,31.5318
NA20356,1287537,93179,0,1380716,93179,0.0,100.0
HG01190,1306642,74074,0,1380716,74074,0.0,100.0
NA18998,1279921,47421,53374,1380716,100795,52.953,47.047
NA18639,1308115,72601,0,1380716,72601,0.0,100.0
NA19664,1306309,74407,0,1380716,74407,0.0,100.0
HG00342,1309540,71176,0,1380716,71176,0.0,100.0
NA18577,1273950,46522,60244,1380716,106766,56.4262,43.5738
NA19081,1278435,47916,54365,1380716,102281,53.1526,46.8474
HG01082,1291824,88892,0,1380716,88892,0.0,100.0
NA20756,1275493,39657,65566,1380716,105223,62.3115,37.6885
NA18498,1280755,99961,0,1380716,99961,0.0,100.0
NA19901,1227914,48707,104095,1380716,152802,68.1241,31.8759
NA20528,1311651,69065,0,1380716,69065,0.0,100.0
NA20294,1235291,42936,102489,1380716,145425,70.4755,29.5245
HG00265,1308327,72389,0,1380716,72389,0.0,100.0
HG00160,1309205,71511,0,1380716,71511,0.0,100.0
NA18980,1279759,47928,53029,1380716,100957,52.5263,47.4737
HG00190,1309652,71064,0,1380716,71064,0.0,100.0
NA20348,1300759,79957,0,1380716,79957,0.0,100.0
HG01105,1261943,40196,78577,1380716,118773,66.1573,33.8427
HG01518,1309802,70914,0,1380716,70914,0.0,100.0
NA12400,1277363,42479,60874,1380716,103353,58.8991,41.1009
NA12043,1311758,68958,0,1380716,68958,0.0,100.0
NA18858,1229401,51558,99757,1380716,151315,65.9267,34.0733
NA18520,1230432,51761,98523,1380716,150284,65.5579,34.4421
NA19654,1277397,47977,55342,1380716,103319,53.5642,46.4358
HG00136,1310692,70024,0,1380716,70024,0.0,100.0
NA20127,1235062,41846,103808,1380716,145654,71.2703,28.7297
NA19068,1304539,76177,0,1380716,76177,0.0,100.0
NA18634,1274694,47590,58432,1380716,106022,55.1131,44.8869
NA20815,1307224,73492,0,1380716,73492,0.0,100.0
NA11933,1279432,42228,59056,1380716,101284,58.3073,41.6927
NA20543,1306784,73932,0,1380716,73932,0.0,100.0
NA19005,1305282,75434,0,1380716,75434,0.0,100.0
NA18959,1305400,75316,0,1380716,75316,0.0,100.0
HG01191,1270059,40921,69736,1380716,110657,63.02,36.98
NA19317,1280123,100593,0,1380716,100593,0.0,100.0
HG00271,1304048,76668,0,1380716,76668,0.0,100.0
NA19467,1230217,50531,99968,1380716,150499,66.4244,33.5756
NA20351,1290160,90556,0,1380716,90556,0.0,100.0
NA20826,1274644,42353,63719,1380716,106072,60.0715,39.9285
NA19713,1233042,41572,106102,1380716,147674,71.8488,28.1512
HG00120,1276553,40460,63703,1380716,104163,61.157,38.843
HG00234,1313719,66997,0,1380716,66997,0.0,100.0
NA19761,1276574,47278,56864,1380716,104142,54.6024,45.3976
HG00512,1303401,77315,0,1380716,77315,0.0,100.0
NA18504,1279317,101399,0,1380716,101399,0.0,100.0
NA12815,1278031,37518,65167,1380716,102685,63.463,36.537
NA19077,1275945,51770,53001,1380716,104771,50.5875,49.4125
NA19328,1225614,57439,97663,1380716,155102,62.967,37.033
HG00337,1275782,40314,64620,1380716,104934,61.5816,38.4184
NA19379,1224837,50898,104981,1380716,155879,67.3478,32.6522
HG01067,1271687,40897,68132,1380716,109029,62.4898,37.5102
NA19007,1307374,73342,0,1380716,73342,0.0,100.0
HG00656,1303502,77214,0,1380716,77214,0.0,100.0
NA12155,1310061,70655,0,1380716,70655,0.0,100.0
HG00133,1276889,40921,62906,1380716,103827,60.5873,39.4127
HG00705,1275731,44404,60581,1380716,104985,57.7044,42.2956
NA18933,1228466,58270,93980,1380716,152250,61.7274,38.2726
NA12751,1278587,41412,60717,1380716,102129,59.4513,40.5487
NA19676,1300258,80458,0,1380716,80458,0.0,100.0
HG00403,1306274,74442,0,1380716,74442,0.0,100.0
HG00638,1263949,41930,74837,1380716,116767,64.0909,35.9091
HG00536,1303958,76758,0,1380716,76758,0.0,100.0
NA18565,1277683,46406,56627,1380716,103033,54.9601,45.0399
HG00127,1275158,41751,63807,1380716,105558,60.4473,39.5527
HG01617,1309734,70982,0,1380716,70982,0.0,100.0
NA20778,1308268,72448,0,1380716,72448,0.0,100.0
HG00525,1276952,47807,55957,1380716,103764,53.9272,46.0728
HG00110,1281550,42908,56258,1380716,99166,56.7311,43.2689
NA19655,1307754,72962,0,1380716,72962,0.0,100.0
HG01047,1306314,74402,0,1380716,74402,0.0,100.0
NA20513,1310759,69957,0,1380716,69957,0.0,100.0
NA20770,1309402,71314,0,1380716,71314,0.0,100.0
NA19084,1276593,50001,54122,1380716,104123,51.9789,48.0211
NA19318,1277911,102805,0,1380716,102805,0.0,100.0
NA19150,1279268,101448,0,1380716,101448,0.0,100.0
NA20537,1311651,69065,0,1380716,69065,0.0,100.0
NA18564,1275975,47159,57582,1380716,104741,54.9756,45.0244
NA20512,1309776,70940,0,1380716,70940,0.0,100.0
HG01360,1272530,39498,68688,1380716,108186,63.4907,36.5093
NA19382,1277646,103070,0,1380716,103070,0.0,100.0
NA19070,1306806,73910,0,1380716,73910,0.0,100.0
HG01170,1292323,88393,0,1380716,88393,0.0,100.0
NA18643,1304460,76256,0,1380716,76256,0.0,100.0
NA18757,1308594,72122,0,1380716,72122,0.0,100.0
NA20298,1286339,94377,0,1380716,94377,0.0,100.0
NA19152,1227878,49958,102880,1380716,152838,67.3131,32.6869
NA19083,1305647,75069,0,1380716,75069,0.0,100.0
HG01495,1271734,45077,63905,1380716,108982,58.6381,41.3619
HG00235,1280375,39443,60898,1380716,100341,60.691,39.309
HG00382,1310140,70576,0,1380716,70576,0.0,100.0
HG00421,1304785,75931,0,1380716,75931,0.0,100.0
HG01345,1275806,40121,64789,1380716,104910,61.7567,38.2433
NA19456,1230565,49368,100783,1380716,150151,67.1211,32.8789
NA20540,1278077,40374,62265,1380716,102639,60.6641,39.3359
NA18487,1277239,103477,0,1380716,103477,0.0,100.0
NA20811,1309336,71380,0,1380716,71380,0.0,100.0
NA19117,1279118,101598,0,1380716,101598,0.0,100.0
NA20807,1278288,43487,58941,1380716,102428,57.5438,42.4562
NA19131,1227665,52706,100345,1380716,153051,65.5631,34.4369
NA18519,1276307,104409,0,1380716,104409,0.0,100.0
NA19446,1228012,50866,101838,1380716,152704,66.6898,33.3102
HG00150,1274784,41599,64333,1380716,105932,60.7305,39.2695
NA19764,1274604,42004,64108,1380716,106112,60.4154,39.5846
HG00256,1309711,71005,0,1380716,71005,0.0,100.0
NA18537,1278556,48968,53192,1380716,102160,52.0673,47.9327
NA20814,1307914,72802,0,1380716,72802,0.0,100.0
NA18526,1279141,48500,53075,1380716,101575,52.252,47.748
HG00243,1310526,70190,0,1380716,70190,0.0,100.0
NA18603,1305051,75665,0,1380716,75665,0.0,100.0
HG00261,1276447,42282,61987,1380716,104269,59.4491,40.5509
NA19740,1269107,43601,68008,1380716,111609,60.9342,39.0658
NA18924,1228357,52582,99777,1380716,152359,65.4881,34.5119
NA20804,1276583,40349,63784,1380716,104133,61.2524,38.7476
NA12890,1277968,39789,62959,1380716,102748,61.2752,38.7248
NA19347,1276743,103973,0,1380716,103973,0.0,100.0
HG00577,1305518,75198,0,1380716,75198,0.0,100.0
HG00177,1277319,41840,61557,1380716,103397,59.5346,40.4654
NA20332,1234228,41478,105010,1380716,146488,71.6851,28.3149
NA18606,1305823,74893,0,1380716,74893,0.0,100.0
NA12761,1277644,44306,58766,1380716,103072,57.0145,42.9855
HG01489,1274375,40099,66242,1380716,106341,62.2921,37.7079
NA19770,1264268,41122,75326,1380716,116448,64.6864,35.3136
NA18992,1280828,47423,52465,1380716,99888,52.5238,47.4762
NA12286,1307279,73437,0,1380716,73437,0.0,100.0
HG00268,1278981,38160,63575,1380716,101735,62.4908,37.5092
HG00543,1273395,46909,60412,1380716,107321,56.2909,43.7091
HG01198,1260605,39240,80871,1380716,120111,67.3302,32.6698
HG00324,1275584,42004,63128,1380716,105132,60.0464,39.9536
NA18853,1278180,102536,0,1380716,102536,0.0,100.0
NA19795,1307714,73002,0,1380716,73002,0.0,100.0
HG00104,1280338,38674,61704,1380716,100378,61.4716,38.5284
NA20510,1308071,72645,0,1380716,72645,0.0,100.0
HG00463,1306459,74257,0,1380716,74257,0.0,100.0
NA19463,1223139,49025,108552,1380716,157577,68.8882,31.1118
NA19149,1229122,49483,102111,1380716,151594,67.3582,32.6418
HG00344,1276044,40978,63694,1380716,104672,60.851,39.149
NA18987,1276669,47862,56185,1380716,104047,53.9996,46.0004
NA18541,1276092,45888,58736,1380716,104624,56.1401,43.8599
HG00130,1278544,39747,62425,1380716,102172,61.098,38.902
HG00129,1308557,72159,0,1380716,72159,0.0,100.0
NA12342,1309416,71300,0,1380716,71300,0.0,100.0
HG00142,1308854,71862,0,1380716,71862,0.0,100.0
HG00464,1277666,48496,54554,1380716,103050,52.9393,47.0607
HG00159,1305917,74799,0,1380716,74799,0.0,100.0
HG00188,1310016,70700,0,1380716,70700,0.0,100.0
NA20281,1280658,100058,0,1380716,100058,0.0,100.0
NA20785,1307566,73150,0,1380716,73150,0.0,100.0
NA19470,1220702,47335,112679,1380716,160014,70.4182,29.5818
NA19917,1225369,52296,103051,1380716,155347,66.336,33.664
HG00384,1278283,36888,65545,1380716,102433,63.9882,36.0118
NA18608,1306094,74622,0,1380716,74622,0.0,100.0
NA12399,1307978,72738,0,1380716,72738,0.0,100.0
NA20363,1233025,42523,105168,1380716,147691,71.2081,28.7919
HG00611,1277406,47560,55750,1380716,103310,53.9638,46.0362
NA12154,1308355,72361,0,1380716,72361,0.0,100.0
NA19707,1252376,43651,84689,1380716,128340,65.988,34.012
NA18966,1306674,74042,0,1380716,74042,0.0,100.0
HG00446,1280293,45297,55126,1380716,100423,54.8938,45.1062
HG01113,1279590,41050,60076,1380716,101126,59.4071,40.5929
NA20296,1239313,42246,99157,1380716,141403,70.1237,29.8763
NA20278,1276001,104715,0,1380716,104715,0.0,100.0
NA19428,1279382,101334,0,1380716,101334,0.0,100.0
NA18536,1306545,74171,0,1380716,74171,0.0,100.0
HG01498,1273615,44889,62212,1380716,107101,58.0872,41.9128
NA12763,1279341,38360,63015,1380716,101375,62.1603,37.8397
HG00553,1306162,74554,0,1380716,74554,0.0,100.0
HG00641,1270100,41203,69413,1380716,110616,62.7513,37.2487
