sample_id,homozygous_reference_alleles,homozygous_alternate_alleles,heterozygous_alternate_alleles,total_callable_sites,total_SNVs,percentage_heterozygous_alternate_alleles,percentage_homozygous_alternate_alleles
HG00096,1186,77,0,1263,77,0.0000,100.0000
HG00097,1152,41,70,1263,111,63.0631,36.9369
HG00099,1168,49,46,1263,95,48.4211,51.5789
HG00100,1162,44,57,1263,101,56.4356,43.5644
HG00101,1187,76,0,1263,76,0.0000,100.0000
HG00102,1167,39,57,1263,96,59.3750,40.6250
HG00103,1185,78,0,1263,78,0.0000,100.0000
HG00104,1160,32,71,1263,103,68.9320,31.0680
HG00106,1153,45,65,1263,110,59.0909,40.9091
HG00108,1185,78,0,1263,78,0.0000,100.0000
HG00109,1190,73,0,1263,73,0.0000,100.0000
HG00110,1161,45,57,1263,102,55.8824,44.1176
HG00111,1163,41,59,1263,100,59.0000,41.0000
HG00112,1185,78,0,1263,78,0.0000,100.0000
HG00113,1192,71,0,1263,71,0.0000,100.0000
HG00114,1180,83,0,1263,83,0.0000,100.0000
HG00116,1187,76,0,1263,76,0.0000,100.0000
HG00117,1191,72,0,1263,72,0.0000,100.0000
HG00118,1159,44,60,1263,104,57.6923,42.3077
HG00119,1186,77,0,1263,77,0.0000,100.0000
HG00120,1162,43,58,1263,101,57.4257,42.5743
HG00121,1163,44,56,1263,100,56.0000,44.0000
HG00122,1157,42,64,1263,106,60.3774,39.6226
HG00123,1160,45,58,1263,103,56.3107,43.6893
HG00124,1156,49,58,1263,107,54.2056,45.7944
HG00125,1154,42,67,1263,109,61.4679,38.5321
HG00126,1183,80,0,1263,80,0.0000,100.0000
HG00127,1150,50,63,1263,113,55.7522,44.2478
HG00128,1163,42,58,1263,100,58.0000,42.0000
HG00129,1190,73,0,1263,73,0.0000,100.0000
HG00130,1161,43,59,1263,102,57.8431,42.1569
HG00131,1195,68,0,1263,68,0.0000,100.0000
HG00133,1153,43,67,1263,110,60.9091,39.0909
HG00134,1157,39,67,1263,106,63.2075,36.7925
HG00135,1166,38,59,1263,97,60.8247,39.1753
HG00136,1192,71,0,1263,71,0.0000,100.0000
HG00137,1165,38,60,1263,98,61.2245,38.7755
HG00138,1190,73,0,1263,73,0.0000,100.0000
HG00139,1194,69,0,1263,69,0.0000,100.0000
HG00140,1184,79,0,1263,79,0.0000,100.0000
HG00141,1183,80,0,1263,80,0.0000,100.0000
HG00142,1189,74,0,1263,74,0.0000,100.0000
HG00143,1186,77,0,1263,77,0.0000,100.0000
HG00146,1151,40,72,1263,112,64.2857,35.7143
HG00148,1194,69,0,1263,69,0.0000,100.0000
HG00149,1183,80,0,1263,80,0.0000,100.0000
HG00150,1154,47,62,1263,109,56.8807,43.1193
HG00151,1190,73,0,1263,73,0.0000,100.0000
HG00152,1181,82,0,1263,82,0.0000,100.0000
HG00154,1168,43,52,1263,95,54.7368,45.2632
HG00155,1191,72,0,1263,72,0.0000,100.0000
HG00156,1186,77,0,1263,77,0.0000,100.0000
HG00158,1162,46,55,1263,101,54.4554,45.5446
HG00159,1195,68,0,1263,68,0.0000,100.0000
HG00160,1191,72,0,1263,72,0.0000,100.0000
HG00171,1154,42,67,1263,109,61.4679,38.5321
HG00173,1153,47,63,1263,110,57.2727,42.7273
HG00174,1147,47,69,1263,116,59.4828,40.5172
HG00176,1142,44,77,1263,121,63.6364,36.3636
HG00177,1166,40,57,1263,97,58.7629,41.2371
HG00178,1165,39,59,1263,98,60.2041,39.7959
HG00179,1170,40,53,1263,93,56.9892,43.0108
HG00180,1156,45,62,1263,107,57.9439,42.0561
HG00182,1184,79,0,1263,79,0.0000,100.0000
HG00183,1185,78,0,1263,78,0.0000,100.0000
HG00185,1191,72,0,1263,72,0.0000,100.0000
HG00186,1194,69,0,1263,69,0.0000,100.0000
HG00187,1198,65,0,1263,65,0.0000,100.0000
HG00188,1185,78,0,1263,78,0.0000,100.0000
HG00189,1197,66,0,1263,66,0.0000,100.0000
HG00190,1181,82,0,1263,82,0.0000,100.0000
HG00231,1153,44,66,1263,110,60.0000,40.0000
HG00232,1159,42,62,1263,104,59.6154,40.3846
HG00233,1158,56,49,1263,105,46.6667,53.3333
HG00234,1193,70,0,1263,70,0.0000,100.0000
HG00235,1158,30,75,1263,105,71.4286,28.5714
HG00236,1151,48,64,1263,112,57.1429,42.8571
HG00237,1149,37,77,1263,114,67.5439,32.4561
HG00238,1151,36,76,1263,112,67.8571,32.1429
HG00239,1169,40,54,1263,94,57.4468,42.5532
HG00240,1166,40,57,1263,97,58.7629,41.2371
HG00242,1189,74,0,1263,74,0.0000,100.0000
HG00243,1191,72,0,1263,72,0.0000,100.0000
HG00244,1183,80,0,1263,80,0.0000,100.0000
HG00245,1168,40,55,1263,95,57.8947,42.1053
HG00246,1186,77,0,1263,77,0.0000,100.0000
HG00247,1145,43,75,1263,118,63.5593,36.4407
HG00249,1158,38,67,1263,105,63.8095,36.1905
HG00250,1147,51,65,1263,116,56.0345,43.9655
HG00251,1182,81,0,1263,81,0.0000,100.0000
HG00252,1199,64,0,1263,64,0.0000,100.0000
HG00253,1157,41,65,1263,106,61.3208,38.6792
HG00254,1163,41,59,1263,100,59.0000,41.0000
HG00255,1163,49,51,1263,100,51.0000,49.0000
HG00256,1183,80,0,1263,80,0.0000,100.0000
HG00257,1156,48,59,1263,107,55.1402,44.8598
HG00258,1166,38,59,1263,97,60.8247,39.1753
HG00259,1161,45,57,1263,102,55.8824,44.1176
HG00260,1190,73,0,1263,73,0.0000,100.0000
HG00261,1156,47,60,1263,107,56.0748,43.9252
HG00262,1171,45,47,1263,92,51.0870,48.9130
HG00263,1159,43,61,1263,104,58.6538,41.3462
HG00264,1180,83,0,1263,83,0.0000,100.0000
HG00265,1193,70,0,1263,70,0.0000,100.0000
HG00266,1161,44,58,1263,102,56.8627,43.1373
HG00267,1189,74,0,1263,74,0.0000,100.0000
HG00268,1171,41,51,1263,92,55.4348,44.5652
HG00269,1152,48,63,1263,111,56.7568,43.2432
HG00270,1158,47,58,1263,105,55.2381,44.7619
HG00271,1192,71,0,1263,71,0.0000,100.0000
HG00272,1158,40,65,1263,105,61.9048,38.0952
HG00273,1197,66,0,1263,66,0.0000,100.0000
HG00274,1154,43,66,1263,109,60.5505,39.4495
HG00275,1156,45,62,1263,107,57.9439,42.0561
HG00276,1157,40,66,1263,106,62.2642,37.7358
HG00277,1197,66,0,1263,66,0.0000,100.0000
HG00278,1180,83,0,1263,83,0.0000,100.0000
HG00280,1185,78,0,1263,78,0.0000,100.0000
HG00281,1150,53,60,1263,113,53.0973,46.9027
HG00282,1149,48,66,1263,114,57.8947,42.1053
HG00284,1186,77,0,1263,77,0.0000,100.0000
HG00285,1157,46,60,1263,106,56.6038,43.3962
HG00306,1164,36,63,1263,99,63.6364,36.3636
HG00309,1155,34,74,1263,108,68.5185,31.4815
HG00310,1192,71,0,1263,71,0.0000,100.0000
HG00311,1202,61,0,1263,61,0.0000,100.0000
HG00312,1186,77,0,1263,77,0.0000,100.0000
HG00313,1150,44,69,1263,113,61.0619,38.9381
HG00315,1156,46,61,1263,107,57.0093,42.9907
HG00318,1163,44,56,1263,100,56.0000,44.0000
HG00319,1157,41,65,1263,106,61.3208,38.6792
HG00320,1159,43,61,1263,104,58.6538,41.3462
HG00321,1183,80,0,1263,80,0.0000,100.0000
HG00323,1159,43,61,1263,104,58.6538,41.3462
HG00324,1152,40,71,1263,111,63.9640,36.0360
HG00325,1187,76,0,1263,76,0.0000,100.0000
HG00326,1156,50,57,1263,107,53.2710,46.7290
HG00327,1151,40,72,1263,112,64.2857,35.7143
HG00328,1155,43,65,1263,108,60.1852,39.8148
HG00329,1193,70,0,1263,70,0.0000,100.0000
HG00330,1162,38,63,1263,101,62.3762,37.6238
HG00331,1168,47,48,1263,95,50.5263,49.4737
HG00332,1155,48,60,1263,108,55.5556,44.4444
HG00334,1158,39,66,1263,105,62.8571,37.1429
HG00335,1194,69,0,1263,69,0.0000,100.0000
HG00336,1178,85,0,1263,85,0.0000,100.0000
HG00337,1149,36,78,1263,114,68.4211,31.5789
HG00338,1191,72,0,1263,72,0.0000,100.0000
HG00339,1161,39,63,1263,102,61.7647,38.2353
HG00341,1194,69,0,1263,69,0.0000,100.0000
HG00342,1198,65,0,1263,65,0.0000,100.0000
HG00343,1162,49,52,1263,101,51.4851,48.5149
HG00344,1160,41,62,1263,103,60.1942,39.8058
HG00345,1179,84,0,1263,84,0.0000,100.0000
HG00346,1165,45,53,1263,98,54.0816,45.9184
HG00349,1170,37,56,1263,93,60.2151,39.7849
HG00350,1169,42,52,1263,94,55.3191,44.6809
HG00351,1185,78,0,1263,78,0.0000,100.0000
HG00353,1159,43,61,1263,104,58.6538,41.3462
HG00355,1159,34,70,1263,104,67.3077,32.6923
HG00356,1163,36,64,1263,100,64.0000,36.0000
HG00357,1166,41,56,1263,97,57.7320,42.2680
HG00358,1195,68,0,1263,68,0.0000,100.0000
HG00359,1166,37,60,1263,97,61.8557,38.1443
HG00360,1205,58,0,1263,58,0.0000,100.0000
HG00361,1184,53,26,1263,79,32.9114,67.0886
HG00362,1175,43,45,1263,88,51.1364,48.8636
HG00364,1163,30,70,1263,100,70.0000,30.0000
HG00366,1196,67,0,1263,67,0.0000,100.0000
HG00367,1155,45,63,1263,108,58.3333,41.6667
HG00369,1190,73,0,1263,73,0.0000,100.0000
HG00372,1186,77,0,1263,77,0.0000,100.0000
HG00373,1163,42,58,1263,100,58.0000,42.0000
HG00375,1179,84,0,1263,84,0.0000,100.0000
HG00376,1162,42,59,1263,101,58.4158,41.5842
HG00377,1172,48,43,1263,91,47.2527,52.7473
HG00378,1162,41,60,1263,101,59.4059,40.5941
HG00381,1168,42,53,1263,95,55.7895,44.2105
HG00382,1191,72,0,1263,72,0.0000,100.0000
HG00383,1162,48,53,1263,101,52.4752,47.5248
HG00384,1165,43,55,1263,98,56.1224,43.8776
HG00403,1179,84,0,1263,84,0.0000,100.0000
HG00404,1159,46,58,1263,104,55.7692,44.2308
HG00406,1180,83,0,1263,83,0.0000,100.0000
HG00407,1162,51,50,1263,101,49.5050,50.4951
HG00418,1192,71,0,1263,71,0.0000,100.0000
HG00419,1169,40,54,1263,94,57.4468,42.5532
HG00421,1184,79,0,1263,79,0.0000,100.0000
HG00422,1157,60,46,1263,106,43.3962,56.6038
HG00427,1184,79,0,1263,79,0.0000,100.0000
HG00428,1150,51,62,1263,113,54.8673,45.1327
HG00436,1180,83,0,1263,83,0.0000,100.0000
HG00437,1149,51,63,1263,114,55.2632,44.7368
HG00442,1183,80,0,1263,80,0.0000,100.0000
HG00443,1153,50,60,1263,110,54.5455,45.4545
HG00445,1185,78,0,1263,78,0.0000,100.0000
HG00446,1152,48,63,1263,111,56.7568,43.2432
HG00448,1182,81,0,1263,81,0.0000,100.0000
HG00449,1150,51,62,1263,113,54.8673,45.1327
HG00451,1178,85,0,1263,85,0.0000,100.0000
HG00452,1156,39,68,1263,107,63.5514,36.4486
HG00457,1193,70,0,1263,70,0.0000,100.0000
HG00458,1161,47,55,1263,102,53.9216,46.0784
HG00463,1184,79,0,1263,79,0.0000,100.0000
HG00464,1147,52,64,1263,116,55.1724,44.8276
HG00472,1189,74,0,1263,74,0.0000,100.0000
HG00473,1159,47,57,1263,104,54.8077,45.1923
HG00475,1190,73,0,1263,73,0.0000,100.0000
HG00476,1153,52,58,1263,110,52.7273,47.2727
HG00478,1186,77,0,1263,77,0.0000,100.0000
HG00479,1161,47,55,1263,102,53.9216,46.0784
HG00500,1181,82,0,1263,82,0.0000,100.0000
HG00501,1147,49,67,1263,116,57.7586,42.2414
HG00512,1177,86,0,1263,86,0.0000,100.0000
HG00513,1152,57,54,1263,111,48.6486,51.3514
HG00524,1176,87,0,1263,87,0.0000,100.0000
HG00525,1147,47,69,1263,116,59.4828,40.5172
HG00530,1182,81,0,1263,81,0.0000,100.0000
HG00531,1161,51,51,1263,102,50.0000,50.0000
HG00533,1184,79,0,1263,79,0.0000,100.0000
HG00534,1146,65,52,1263,117,44.4444,55.5556
HG00536,1188,75,0,1263,75,0.0000,100.0000
HG00537,1155,61,47,1263,108,43.5185,56.4815
HG00542,1195,68,0,1263,68,0.0000,100.0000
HG00543,1159,45,59,1263,104,56.7308,43.2692
HG00553,1172,91,0,1263,91,0.0000,100.0000
HG00554,1151,52,60,1263,112,53.5714,46.4286
HG00556,1172,91,0,1263,91,0.0000,100.0000
HG00557,1159,54,50,1263,104,48.0769,51.9231
HG00559,1183,80,0,1263,80,0.0000,100.0000
HG00560,1148,53,62,1263,115,53.9130,46.0870
HG00565,1180,83,0,1263,83,0.0000,100.0000
HG00566,1152,50,61,1263,111,54.9550,45.0450
HG00577,1185,78,0,1263,78,0.0000,100.0000
HG00578,1141,45,77,1263,122,63.1148,36.8852
HG00580,1187,76,0,1263,76,0.0000,100.0000
HG00581,1147,48,68,1263,116,58.6207,41.3793
HG00583,1185,78,0,1263,78,0.0000,100.0000
HG00584,1154,51,58,1263,109,53.2110,46.7890
HG00589,1184,79,0,1263,79,0.0000,100.0000
HG00590,1152,49,62,1263,111,55.8559,44.1441
HG00592,1180,83,0,1263,83,0.0000,100.0000
HG00593,1157,45,61,1263,106,57.5472,42.4528
HG00595,1178,85,0,1263,85,0.0000,100.0000
HG00596,1148,50,65,1263,115,56.5217,43.4783
HG00607,1180,83,0,1263,83,0.0000,100.0000
HG00608,1160,46,57,1263,103,55.3398,44.6602
HG00610,1174,89,0,1263,89,0.0000,100.0000
HG00611,1152,48,63,1263,111,56.7568,43.2432
HG00613,1180,83,0,1263,83,0.0000,100.0000
HG00614,1150,56,57,1263,113,50.4425,49.5575
HG00619,1182,81,0,1263,81,0.0000,100.0000
HG00620,1156,44,63,1263,107,58.8785,41.1215
HG00625,1181,82,0,1263,82,0.0000,100.0000
HG00626,1162,55,46,1263,101,45.5446,54.4554
HG00628,1185,78,0,1263,78,0.0000,100.0000
HG00629,1150,46,67,1263,113,59.2920,40.7080
HG00634,1184,79,0,1263,79,0.0000,100.0000
HG00635,1154,54,55,1263,109,50.4587,49.5413
HG00637,1187,76,0,1263,76,0.0000,100.0000
HG00638,1140,44,79,1263,123,64.2276,35.7724
HG00640,1186,77,0,1263,77,0.0000,100.0000
HG00641,1147,38,78,1263,116,67.2414,32.7586
HG00650,1174,89,0,1263,89,0.0000,100.0000
HG00651,1163,52,48,1263,100,48.0000,52.0000
HG00653,1186,77,0,1263,77,0.0000,100.0000
HG00654,1156,55,52,1263,107,48.5981,51.4019
HG00656,1176,87,0,1263,87,0.0000,100.0000
HG00657,1152,51,60,1263,111,54.0541,45.9459
HG00662,1186,77,0,1263,77,0.0000,100.0000
HG00663,1158,54,51,1263,105,48.5714,51.4286
HG00671,1184,79,0,1263,79,0.0000,100.0000
HG00672,1157,46,60,1263,106,56.6038,43.3962
HG00683,1181,82,0,1263,82,0.0000,100.0000
HG00684,1139,52,72,1263,124,58.0645,41.9355
HG00689,1187,76,0,1263,76,0.0000,100.0000
HG00690,1152,49,62,1263,111,55.8559,44.1441
HG00692,1172,91,0,1263,91,0.0000,100.0000
HG00693,1158,47,58,1263,105,55.2381,44.7619
HG00698,1172,91,0,1263,91,0.0000,100.0000
HG00699,1159,47,57,1263,104,54.8077,45.1923
HG00701,1176,87,0,1263,87,0.0000,100.0000
HG00702,1152,53,58,1263,111,52.2523,47.7477
HG00704,1189,74,0,1263,74,0.0000,100.0000
HG00705,1154,50,59,1263,109,54.1284,45.8716
HG00707,1186,77,0,1263,77,0.0000,100.0000
HG00708,1150,55,58,1263,113,51.3274,48.6726
HG00731,1185,78,0,1263,78,0.0000,100.0000
HG00732,1153,40,70,1263,110,63.6364,36.3636
HG00734,1126,37,100,1263,137,72.9927,27.0073
HG00736,1195,68,0,1263,68,0.0000,100.0000
HG00737,1141,37,85,1263,122,69.6721,30.3279
HG00740,1151,42,70,1263,112,62.5000,37.5000
HG01047,1190,73,0,1263,73,0.0000,100.0000
HG01048,1183,80,0,1263,80,0.0000,100.0000
HG01051,1162,101,0,1263,101,0.0000,100.0000
HG01052,1113,45,105,1263,150,70.0000,30.0000
HG01055,1149,45,69,1263,114,60.5263,39.4737
HG01060,1168,95,0,1263,95,0.0000,100.0000
HG01061,1143,46,74,1263,120,61.6667,38.3333
HG01066,1182,81,0,1263,81,0.0000,100.0000
HG01067,1150,46,67,1263,113,59.2920,40.7080
HG01069,1186,77,0,1263,77,0.0000,100.0000
HG01070,1133,48,82,1263,130,63.0769,36.9231
HG01072,1180,83,0,1263,83,0.0000,100.0000
HG01073,1141,45,77,1263,122,63.1148,36.8852
HG01075,1175,88,0,1263,88,0.0000,100.0000
HG01079,1181,82,0,1263,82,0.0000,100.0000
HG01080,1148,37,78,1263,115,67.8261,32.1739
HG01082,1171,92,0,1263,92,0.0000,100.0000
HG01083,1143,52,68,1263,120,56.6667,43.3333
HG01085,1188,75,0,1263,75,0.0000,100.0000
HG01095,1138,35,90,1263,125,72.0000,28.0000
HG01097,1194,69,0,1263,69,0.0000,100.0000
HG01098,1153,38,72,1263,110,65.4545,34.5455
HG01101,1182,81,0,1263,81,0.0000,100.0000
HG01102,1152,44,67,1263,111,60.3604,39.6396
HG01104,1186,77,0,1263,77,0.0000,100.0000
HG01105,1141,39,83,1263,122,68.0328,31.9672
HG01107,1179,84,0,1263,84,0.0000,100.0000
HG01108,1126,58,79,1263,137,57.6642,42.3358
HG01112,1185,78,0,1263,78,0.0000,100.0000
HG01113,1160,40,63,1263,103,61.1650,38.8350
HG01124,1184,79,0,1263,79,0.0000,100.0000
HG01125,1166,37,60,1263,97,61.8557,38.1443
HG01133,1182,81,0,1263,81,0.0000,100.0000
HG01134,1158,45,60,1263,105,57.1429,42.8571
HG01136,1180,83,0,1263,83,0.0000,100.0000
HG01137,1147,47,69,1263,116,59.4828,40.5172
HG01140,1137,46,80,1263,126,63.4921,36.5079
HG01148,1180,83,0,1263,83,0.0000,100.0000
HG01149,1148,52,63,1263,115,54.7826,45.2174
HG01167,1174,89,0,1263,89,0.0000,100.0000
HG01168,1163,38,62,1263,100,62.0000,38.0000
HG01170,1173,90,0,1263,90,0.0000,100.0000
HG01171,1144,40,79,1263,119,66.3866,33.6134
HG01173,1189,74,0,1263,74,0.0000,100.0000
HG01174,1147,42,74,1263,116,63.7931,36.2069
HG01176,1168,95,0,1263,95,0.0000,100.0000
HG01183,1149,37,77,1263,114,67.5439,32.4561
HG01187,1168,95,0,1263,95,0.0000,100.0000
HG01188,1120,43,100,1263,143,69.9301,30.0699
HG01190,1179,84,0,1263,84,0.0000,100.0000
HG01191,1158,41,64,1263,105,60.9524,39.0476
HG01197,1180,83,0,1263,83,0.0000,100.0000
HG01198,1143,45,75,1263,120,62.5000,37.5000
HG01204,1184,79,0,1263,79,0.0000,100.0000
HG01250,1175,88,0,1263,88,0.0000,100.0000
HG01251,1150,38,75,1263,113,66.3717,33.6283
HG01257,1149,39,75,1263,114,65.7895,34.2105
HG01259,1186,77,0,1263,77,0.0000,100.0000
HG01271,1185,78,0,1263,78,0.0000,100.0000
HG01272,1156,41,66,1263,107,61.6822,38.3178
HG01274,1188,75,0,1263,75,0.0000,100.0000
HG01275,1161,37,65,1263,102,63.7255,36.2745
HG01277,1185,78,0,1263,78,0.0000,100.0000
HG01278,1149,39,75,1263,114,65.7895,34.2105
HG01334,1185,78,0,1263,78,0.0000,100.0000
HG01342,1108,43,112,1263,155,72.2581,27.7419
HG01344,1190,73,0,1263,73,0.0000,100.0000
HG01345,1155,38,70,1263,108,64.8148,35.1852
HG01350,1178,85,0,1263,85,0.0000,100.0000
HG01351,1154,46,63,1263,109,57.7982,42.2018
HG01353,1187,76,0,1263,76,0.0000,100.0000
HG01354,1159,41,63,1263,104,60.5769,39.4231
HG01356,1189,74,0,1263,74,0.0000,100.0000
HG01357,1159,47,57,1263,104,54.8077,45.1923
HG01359,1190,73,0,1263,73,0.0000,100.0000
HG01360,1144,39,80,1263,119,67.2269,32.7731
HG01365,1167,96,0,1263,96,0.0000,100.0000
HG01366,1119,47,97,1263,144,67.3611,32.6389
HG01374,1188,75,0,1263,75,0.0000,100.0000
HG01375,1149,39,75,1263,114,65.7895,34.2105
HG01377,1180,83,0,1263,83,0.0000,100.0000
HG01378,1154,49,60,1263,109,55.0459,44.9541
HG01383,1179,84,0,1263,84,0.0000,100.0000
HG01384,1135,47,81,1263,128,63.2813,36.7188
HG01389,1191,72,0,1263,72,0.0000,100.0000
HG01390,1119,50,94,1263,144,65.2778,34.7222
HG01437,1188,75,0,1263,75,0.0000,100.0000
HG01440,1184,79,0,1263,79,0.0000,100.0000
HG01441,1154,47,62,1263,109,56.8807,43.1193
HG01455,1177,86,0,1263,86,0.0000,100.0000
HG01456,1149,53,61,1263,114,53.5088,46.4912
HG01461,1172,91,0,1263,91,0.0000,100.0000
HG01462,1135,44,84,1263,128,65.6250,34.3750
HG01465,1170,39,54,1263,93,58.0645,41.9355
HG01488,1190,73,0,1263,73,0.0000,100.0000
HG01489,1152,41,70,1263,111,63.0631,36.9369
HG01491,1192,71,0,1263,71,0.0000,100.0000
HG01492,1146,39,78,1263,117,66.6667,33.3333
HG01494,1191,72,0,1263,72,0.0000,100.0000
HG01495,1147,56,60,1263,116,51.7241,48.2759
HG01497,1169,94,0,1263,94,0.0000,100.0000
HG01498,1157,42,64,1263,106,60.3774,39.6226
HG01515,1189,74,0,1263,74,0.0000,100.0000
HG01516,1157,48,58,1263,106,54.7170,45.2830
HG01518,1184,79,0,1263,79,0.0000,100.0000
HG01519,1164,51,48,1263,99,48.4848,51.5152
HG01521,1190,73,0,1263,73,0.0000,100.0000
HG01522,1150,49,64,1263,113,56.6372,43.3628
HG01550,1187,76,0,1263,76,0.0000,100.0000
HG01551,1131,40,92,1263,132,69.6970,30.3030
HG01617,1198,65,0,1263,65,0.0000,100.0000
HG01618,1157,40,66,1263,106,62.2642,37.7358
HG01619,1201,62,0,1263,62,0.0000,100.0000
HG01620,1153,39,71,1263,110,64.5455,35.4545
HG01623,1157,44,62,1263,106,58.4906,41.5094
HG01624,1198,65,0,1263,65,0.0000,100.0000
HG01625,1184,79,0,1263,79,0.0000,100.0000
HG01626,1172,32,59,1263,91,64.8352,35.1648
NA06984,1189,74,0,1263,74,0.0000,100.0000
NA06986,1184,79,0,1263,79,0.0000,100.0000
NA06989,1159,45,59,1263,104,56.7308,43.2692
NA06994,1185,78,0,1263,78,0.0000,100.0000
NA07000,1159,44,60,1263,104,57.6923,42.3077
NA07037,1154,41,68,1263,109,62.3853,37.6147
NA07048,1191,72,0,1263,72,0.0000,100.0000
NA07051,1186,77,0,1263,77,0.0000,100.0000
NA07056,1161,41,61,1263,102,59.8039,40.1961
NA07347,1179,84,0,1263,84,0.0000,100.0000
NA07357,1180,83,0,1263,83,0.0000,100.0000
NA10847,1159,41,63,1263,104,60.5769,39.4231
NA10851,1192,71,0,1263,71,0.0000,100.0000
NA11829,1197,66,0,1263,66,0.0000,100.0000
NA11830,1167,47,49,1263,96,51.0417,48.9583
NA11831,1190,73,0,1263,73,0.0000,100.0000
NA11843,1190,73,0,1263,73,0.0000,100.0000
NA11892,1160,40,63,1263,103,61.1650,38.8350
NA11893,1187,76,0,1263,76,0.0000,100.0000
NA11894,1145,47,71,1263,118,60.1695,39.8305
NA11919,1188,75,0,1263,75,0.0000,100.0000
NA11920,1163,36,64,1263,100,64.0000,36.0000
NA11930,1187,76,0,1263,76,0.0000,100.0000
NA11931,1159,43,61,1263,104,58.6538,41.3462
NA11932,1193,70,0,1263,70,0.0000,100.0000
NA11933,1158,47,58,1263,105,55.2381,44.7619
NA11992,1195,68,0,1263,68,0.0000,100.0000
NA11993,1157,35,71,1263,106,66.9811,33.0189
NA11994,1183,80,0,1263,80,0.0000,100.0000
NA11995,1163,45,55,1263,100,55.0000,45.0000
NA12003,1192,71,0,1263,71,0.0000,100.0000
NA12004,1152,48,63,1263,111,56.7568,43.2432
NA12006,1168,42,53,1263,95,55.7895,44.2105
NA12043,1193,70,0,1263,70,0.0000,100.0000
NA12044,1163,46,54,1263,100,54.0000,46.0000
NA12045,1187,76,0,1263,76,0.0000,100.0000
NA12046,1164,43,56,1263,99,56.5657,43.4343
NA12058,1153,46,64,1263,110,58.1818,41.8182
NA12144,1186,77,0,1263,77,0.0000,100.0000
NA12154,1178,85,0,1263,85,0.0000,100.0000
NA12155,1181,82,0,1263,82,0.0000,100.0000
NA12249,1170,48,45,1263,93,48.3871,51.6129
NA12272,1196,67,0,1263,67,0.0000,100.0000
NA12273,1156,42,65,1263,107,60.7477,39.2523
NA12275,1161,42,60,1263,102,58.8235,41.1765
NA12282,1190,73,0,1263,73,0.0000,100.0000
NA12283,1161,40,62,1263,102,60.7843,39.2157
NA12286,1186,77,0,1263,77,0.0000,100.0000
NA12287,1159,48,56,1263,104,53.8462,46.1538
NA12340,1181,82,0,1263,82,0.0000,100.0000
NA12341,1161,40,62,1263,102,60.7843,39.2157
NA12342,1184,79,0,1263,79,0.0000,100.0000
NA12347,1193,70,0,1263,70,0.0000,100.0000
NA12348,1150,56,57,1263,113,50.4425,49.5575
NA12383,1144,47,72,1263,119,60.5042,39.4958
NA12399,1185,78,0,1263,78,0.0000,100.0000
NA12400,1151,43,69,1263,112,61.6071,38.3929
NA12413,1190,73,0,1263,73,0.0000,100.0000
NA12489,1160,47,56,1263,103,54.3689,45.6311
NA12546,1187,76,0,1263,76,0.0000,100.0000
NA12716,1193,70,0,1263,70,0.0000,100.0000
NA12717,1149,45,69,1263,114,60.5263,39.4737
NA12718,1152,48,63,1263,111,56.7568,43.2432
NA12748,1183,80,0,1263,80,0.0000,100.0000
NA12749,1154,41,68,1263,109,62.3853,37.6147
NA12750,1183,80,0,1263,80,0.0000,100.0000
NA12751,1156,43,64,1263,107,59.8131,40.1869
NA12761,1162,45,56,1263,101,55.4455,44.5545
NA12763,1149,33,81,1263,114,71.0526,28.9474
NA12775,1184,79,0,1263,79,0.0000,100.0000
NA12777,1186,77,0,1263,77,0.0000,100.0000
NA12778,1151,41,71,1263,112,63.3929,36.6071
NA12812,1188,75,0,1263,75,0.0000,100.0000
NA12814,1200,63,0,1263,63,0.0000,100.0000
NA12815,1165,40,58,1263,98,59.1837,40.8163
NA12827,1184,79,0,1263,79,0.0000,100.0000
NA12829,1180,83,0,1263,83,0.0000,100.0000
NA12830,1158,37,68,1263,105,64.7619,35.2381
NA12842,1191,72,0,1263,72,0.0000,100.0000
NA12843,1161,41,61,1263,102,59.8039,40.1961
NA12872,1197,66,0,1263,66,0.0000,100.0000
NA12873,1155,44,64,1263,108,59.2593,40.7407
NA12874,1191,72,0,1263,72,0.0000,100.0000
NA12889,1197,66,0,1263,66,0.0000,100.0000
NA12890,1155,42,66,1263,108,61.1111,38.8889
NA18486,1162,101,0,1263,101,0.0000,100.0000
NA18487,1153,110,0,1263,110,0.0000,100.0000
NA18489,1116,59,88,1263,147,59.8639,40.1361
NA18498,1158,105,0,1263,105,0.0000,100.0000
NA18499,1104,52,107,1263,159,67.2956,32.7044
NA18501,1163,100,0,1263,100,0.0000,100.0000
NA18502,1116,59,88,1263,147,59.8639,40.1361
NA18504,1162,101,0,1263,101,0.0000,100.0000
NA18505,1096,54,113,1263,167,67.6647,32.3353
NA18507,1158,105,0,1263,105,0.0000,100.0000
NA18508,1122,47,94,1263,141,66.6667,33.3333
NA18510,1157,106,0,1263,106,0.0000,100.0000
NA18511,1105,54,104,1263,158,65.8228,34.1772
NA18516,1159,104,0,1263,104,0.0000,100.0000
NA18517,1093,51,119,1263,170,70.0000,30.0000
NA18519,1167,96,0,1263,96,0.0000,100.0000
NA18520,1112,59,92,1263,151,60.9272,39.0728
NA18522,1159,104,0,1263,104,0.0000,100.0000
NA18523,1115,57,91,1263,148,61.4865,38.5135
NA18525,1163,48,52,1263,100,52.0000,48.0000
NA18526,1156,49,58,1263,107,54.2056,45.7944
NA18527,1160,48,55,1263,103,53.3981,46.6019
NA18528,1157,52,54,1263,106,50.9434,49.0566
NA18530,1189,74,0,1263,74,0.0000,100.0000
NA18532,1153,56,54,1263,110,49.0909,50.9091
NA18534,1177,86,0,1263,86,0.0000,100.0000
NA18535,1152,49,62,1263,111,55.8559,44.1441
NA18536,1188,75,0,1263,75,0.0000,100.0000
NA18537,1162,50,51,1263,101,50.4951,49.5050
NA18538,1150,49,64,1263,113,56.6372,43.3628
NA18539,1162,58,43,1263,101,42.5743,57.4257
NA18541,1148,49,66,1263,115,57.3913,42.6087
NA18542,1153,48,62,1263,110,56.3636,43.6364
NA18543,1181,82,0,1263,82,0.0000,100.0000
NA18544,1172,91,0,1263,91,0.0000,100.0000
NA18545,1150,56,57,1263,113,50.4425,49.5575
NA18546,1177,86,0,1263,86,0.0000,100.0000
NA18547,1159,51,53,1263,104,50.9615,49.0385
NA18548,1177,86,0,1263,86,0.0000,100.0000
NA18549,1181,82,0,1263,82,0.0000,100.0000
NA18550,1154,54,55,1263,109,50.4587,49.5413
NA18552,1152,54,57,1263,111,51.3514,48.6486
NA18553,1159,54,50,1263,104,48.0769,51.9231
NA18555,1144,52,67,1263,119,56.3025,43.6975
NA18557,1192,71,0,1263,71,0.0000,100.0000
NA18558,1183,80,0,1263,80,0.0000,100.0000
NA18559,1189,74,0,1263,74,0.0000,100.0000
NA18560,1150,44,69,1263,113,61.0619,38.9381
NA18561,1175,88,0,1263,88,0.0000,100.0000
NA18562,1180,83,0,1263,83,0.0000,100.0000
NA18563,1178,85,0,1263,85,0.0000,100.0000
NA18564,1154,53,56,1263,109,51.3761,48.6239
NA18565,1160,46,57,1263,103,55.3398,44.6602
NA18566,1153,50,60,1263,110,54.5455,45.4545
NA18567,1145,53,65,1263,118,55.0847,44.9153
NA18570,1142,56,65,1263,121,53.7190,46.2810
NA18571,1153,53,57,1263,110,51.8182,48.1818
NA18572,1183,80,0,1263,80,0.0000,100.0000
NA18573,1172,50,41,1263,91,45.0549,54.9451
NA18574,1149,51,63,1263,114,55.2632,44.7368
NA18576,1158,48,57,1263,105,54.2857,45.7143
NA18577,1152,58,53,1263,111,47.7477,52.2523
NA18579,1157,51,55,1263,106,51.8868,48.1132
NA18582,1158,44,61,1263,105,58.0952,41.9048
NA18592,1154,54,55,1263,109,50.4587,49.5413
NA18593,1150,55,58,1263,113,51.3274,48.6726
NA18595,1163,42,58,1263,100,58.0000,42.0000
NA18596,1151,48,64,1263,112,57.1429,42.8571
NA18597,1161,52,50,1263,102,49.0196,50.9804
NA18599,1150,54,59,1263,113,52.2124,47.7876
NA18602,1149,49,65,1263,114,57.0175,42.9825
NA18603,1184,79,0,1263,79,0.0000,100.0000
NA18605,1174,89,0,1263,89,0.0000,100.0000
NA18606,1191,72,0,1263,72,0.0000,100.0000
NA18608,1189,74,0,1263,74,0.0000,100.0000
NA18609,1179,84,0,1263,84,0.0000,100.0000
NA18610,1160,45,58,1263,103,56.3107,43.6893
NA18611,1179,84,0,1263,84,0.0000,100.0000
NA18612,1189,74,0,1263,74,0.0000,100.0000
NA18613,1177,86,0,1263,86,0.0000,100.0000
NA18614,1147,57,59,1263,116,50.8621,49.1379
NA18615,1154,56,53,1263,109,48.6239,51.3761
NA18616,1149,54,60,1263,114,52.6316,47.3684
NA18617,1155,47,61,1263,108,56.4815,43.5185
NA18618,1162,56,45,1263,101,44.5545,55.4455
NA18619,1156,56,51,1263,107,47.6636,52.3364
NA18620,1179,84,0,1263,84,0.0000,100.0000
NA18621,1179,84,0,1263,84,0.0000,100.0000
NA18622,1193,70,0,1263,70,0.0000,100.0000
NA18623,1179,84,0,1263,84,0.0000,100.0000
NA18624,1179,84,0,1263,84,0.0000,100.0000
NA18626,1151,52,60,1263,112,53.5714,46.4286
NA18627,1162,48,53,1263,101,52.4752,47.5248
NA18628,1158,51,54,1263,105,51.4286,48.5714
NA18630,1154,42,67,1263,109,61.4679,38.5321
NA18631,1139,55,69,1263,124,55.6452,44.3548
NA18632,1184,79,0,1263,79,0.0000,100.0000
NA18633,1183,80,0,1263,80,0.0000,100.0000
NA18634,1151,45,67,1263,112,59.8214,40.1786
NA18635,1180,83,0,1263,83,0.0000,100.0000
NA18636,1178,85,0,1263,85,0.0000,100.0000
NA18637,1182,81,0,1263,81,0.0000,100.0000
NA18638,1186,77,0,1263,77,0.0000,100.0000
NA18639,1193,70,0,1263,70,0.0000,100.0000
NA18640,1152,47,64,1263,111,57.6577,42.3423
NA18641,1166,50,47,1263,97,48.4536,51.5464
NA18642,1162,43,58,1263,101,57.4257,42.5743
NA18643,1176,87,0,1263,87,0.0000,100.0000
NA18645,1181,82,0,1263,82,0.0000,100.0000
NA18647,1180,83,0,1263,83,0.0000,100.0000
NA18740,1185,78,0,1263,78,0.0000,100.0000
NA18745,1180,83,0,1263,83,0.0000,100.0000
NA18747,1185,78,0,1263,78,0.0000,100.0000
NA18748,1190,73,0,1263,73,0.0000,100.0000
NA18749,1192,71,0,1263,71,0.0000,100.0000
NA18757,1184,79,0,1263,79,0.0000,100.0000
NA18853,1168,95,0,1263,95,0.0000,100.0000
NA18856,1158,105,0,1263,105,0.0000,100.0000
NA18858,1101,51,111,1263,162,68.5185,31.4815
NA18861,1109,57,97,1263,154,62.9870,37.0130
NA18867,1106,48,109,1263,157,69.4268,30.5732
NA18868,1161,102,0,1263,102,0.0000,100.0000
NA18870,1117,47,99,1263,146,67.8082,32.1918
NA18871,1160,103,0,1263,103,0.0000,100.0000
NA18873,1122,48,93,1263,141,65.9574,34.0426
NA18874,1165,98,0,1263,98,0.0000,100.0000
NA18907,1108,47,108,1263,155,69.6774,30.3226
NA18908,1148,115,0,1263,115,0.0000,100.0000
NA18909,1109,64,90,1263,154,58.4416,41.5584
NA18910,1157,106,0,1263,106,0.0000,100.0000
NA18912,1112,59,92,1263,151,60.9272,39.0728
NA18916,1102,55,106,1263,161,65.8385,34.1615
NA18917,1163,100,0,1263,100,0.0000,100.0000
NA18923,1157,106,0,1263,106,0.0000,100.0000
NA18924,1114,60,89,1263,149,59.7315,40.2685
NA18933,1113,67,83,1263,150,55.3333,44.6667
NA18934,1147,116,0,1263,116,0.0000,100.0000
NA18939,1156,48,59,1263,107,55.1402,44.8598
NA18940,1180,83,0,1263,83,0.0000,100.0000
NA18941,1147,51,65,1263,116,56.0345,43.9655
NA18942,1150,57,56,1263,113,49.5575,50.4425
NA18943,1194,69,0,1263,69,0.0000,100.0000
NA18944,1175,88,0,1263,88,0.0000,100.0000
NA18945,1192,71,0,1263,71,0.0000,100.0000
NA18946,1149,53,61,1263,114,53.5088,46.4912
NA18947,1155,54,54,1263,108,50.0000,50.0000
NA18948,1186,77,0,1263,77,0.0000,100.0000
NA18949,1165,45,53,1263,98,54.0816,45.9184
NA18950,1151,54,58,1263,112,51.7857,48.2143
NA18951,1147,43,73,1263,116,62.9310,37.0690
NA18952,1188,75,0,1263,75,0.0000,100.0000
NA18953,1188,75,0,1263,75,0.0000,100.0000
NA18954,1153,51,59,1263,110,53.6364,46.3636
NA18956,1151,55,57,1263,112,50.8929,49.1071
NA18957,1153,38,72,1263,110,65.4545,34.5455
NA18959,1185,78,0,1263,78,0.0000,100.0000
NA18960,1179,84,0,1263,84,0.0000,100.0000
NA18961,1186,77,0,1263,77,0.0000,100.0000
NA18962,1191,72,0,1263,72,0.0000,100.0000
NA18963,1160,53,50,1263,103,48.5437,51.4563
NA18964,1156,50,57,1263,107,53.2710,46.7290
NA18965,1190,73,0,1263,73,0.0000,100.0000
NA18966,1179,84,0,1263,84,0.0000,100.0000
NA18968,1161,50,52,1263,102,50.9804,49.0196
NA18971,1185,78,0,1263,78,0.0000,100.0000
NA18973,1164,48,51,1263,99,51.5152,48.4848
NA18974,1185,78,0,1263,78,0.0000,100.0000
NA18975,1157,39,67,1263,106,63.2075,36.7925
NA18976,1150,50,63,1263,113,55.7522,44.2478
NA18977,1181,82,0,1263,82,0.0000,100.0000
NA18978,1159,37,67,1263,104,64.4231,35.5769
NA18980,1154,49,60,1263,109,55.0459,44.9541
NA18981,1151,50,62,1263,112,55.3571,44.6429
NA18982,1198,65,0,1263,65,0.0000,100.0000
NA18983,1182,81,0,1263,81,0.0000,100.0000
NA18984,1177,86,0,1263,86,0.0000,100.0000
NA18985,1180,83,0,1263,83,0.0000,100.0000
NA18986,1184,79,0,1263,79,0.0000,100.0000
NA18987,1150,50,63,1263,113,55.7522,44.2478
NA18988,1176,87,0,1263,87,0.0000,100.0000
NA18989,1184,79,0,1263,79,0.0000,100.0000
NA18990,1178,85,0,1263,85,0.0000,100.0000
NA18992,1165,50,48,1263,98,48.9796,51.0204
NA18994,1189,74,0,1263,74,0.0000,100.0000
NA18995,1197,66,0,1263,66,0.0000,100.0000
NA18998,1152,50,61,1263,111,54.9550,45.0450
NA18999,1150,53,60,1263,113,53.0973,46.9027
NA19000,1184,79,0,1263,79,0.0000,100.0000
NA19002,1158,55,50,1263,105,47.6190,52.3810
NA19003,1161,50,52,1263,102,50.9804,49.0196
NA19004,1180,83,0,1263,83,0.0000,100.0000
NA19005,1183,80,0,1263,80,0.0000,100.0000
NA19007,1183,80,0,1263,80,0.0000,100.0000
NA19009,1184,79,0,1263,79,0.0000,100.0000
NA19010,1153,54,56,1263,110,50.9091,49.0909
NA19012,1180,83,0,1263,83,0.0000,100.0000
NA19020,1175,88,0,1263,88,0.0000,100.0000
NA19028,1163,100,0,1263,100,0.0000,100.0000
NA19035,1162,101,0,1263,101,0.0000,100.0000
NA19036,1114,57,92,1263,149,61.7450,38.2550
NA19038,1101,46,116,1263,162,71.6049,28.3951
NA19041,1154,109,0,1263,109,0.0000,100.0000
NA19044,1181,82,0,1263,82,0.0000,100.0000
NA19046,1165,98,0,1263,98,0.0000,100.0000
NA19054,1148,55,60,1263,115,52.1739,47.8261
NA19055,1187,76,0,1263,76,0.0000,100.0000
NA19056,1172,91,0,1263,91,0.0000,100.0000
NA19057,1147,57,59,1263,116,50.8621,49.1379
NA19058,1186,77,0,1263,77,0.0000,100.0000
NA19059,1153,53,57,1263,110,51.8182,48.1818
NA19060,1188,75,0,1263,75,0.0000,100.0000
NA19062,1176,87,0,1263,87,0.0000,100.0000
NA19063,1194,69,0,1263,69,0.0000,100.0000
NA19064,1160,54,49,1263,103,47.5728,52.4272
NA19065,1153,47,63,1263,110,57.2727,42.7273
NA19066,1179,84,0,1263,84,0.0000,100.0000
NA19067,1187,76,0,1263,76,0.0000,100.0000
NA19068,1179,84,0,1263,84,0.0000,100.0000
NA19070,1181,82,0,1263,82,0.0000,100.0000
NA19072,1189,74,0,1263,74,0.0000,100.0000
NA19074,1146,56,61,1263,117,52.1368,47.8632
NA19075,1184,79,0,1263,79,0.0000,100.0000
NA19076,1190,73,0,1263,73,0.0000,100.0000
NA19077,1151,54,58,1263,112,51.7857,48.2143
NA19078,1149,48,66,1263,114,57.8947,42.1053
NA19079,1189,74,0,1263,74,0.0000,100.0000
NA19080,1157,44,62,1263,106,58.4906,41.5094
NA19081,1161,50,52,1263,102,50.9804,49.0196
NA19082,1191,72,0,1263,72,0.0000,100.0000
NA19083,1173,90,0,1263,90,0.0000,100.0000
NA19084,1148,48,67,1263,115,58.2609,41.7391
NA19085,1176,87,0,1263,87,0.0000,100.0000
NA19087,1154,56,53,1263,109,48.6239,51.3761
NA19088,1186,77,0,1263,77,0.0000,100.0000
NA19093,1107,56,100,1263,156,64.1026,35.8974
NA19095,1119,48,96,1263,144,66.6667,33.3333
NA19096,1165,98,0,1263,98,0.0000,100.0000
NA19098,1162,101,0,1263,101,0.0000,100.0000
NA19099,1128,40,95,1263,135,70.3704,29.6296
NA19102,1102,56,105,1263,161,65.2174,34.7826
NA19107,1152,111,0,1263,111,0.0000,100.0000
NA19108,1119,48,96,1263,144,66.6667,33.3333
NA19113,1156,107,0,1263,107,0.0000,100.0000
NA19114,1099,57,107,1263,164,65.2439,34.7561
NA19116,1115,55,93,1263,148,62.8378,37.1622
NA19117,1161,102,0,1263,102,0.0000,100.0000
NA19118,1131,47,85,1263,132,64.3939,35.6061
NA19119,1157,106,0,1263,106,0.0000,100.0000
NA19121,1166,97,0,1263,97,0.0000,100.0000
NA19129,1096,49,118,1263,167,70.6587,29.3413
NA19130,1165,98,0,1263,98,0.0000,100.0000
NA19131,1113,51,99,1263,150,66.0000,34.0000
NA19137,1098,50,115,1263,165,69.6970,30.3030
NA19138,1175,88,0,1263,88,0.0000,100.0000
NA19146,1159,104,0,1263,104,0.0000,100.0000
NA19147,1112,56,95,1263,151,62.9139,37.0861
NA19149,1098,51,114,1263,165,69.0909,30.9091
NA19150,1152,111,0,1263,111,0.0000,100.0000
NA19152,1105,54,104,1263,158,65.8228,34.1772
NA19160,1157,106,0,1263,106,0.0000,100.0000
NA19171,1149,114,0,1263,114,0.0000,100.0000
NA19172,1102,53,108,1263,161,67.0807,32.9193
NA19175,1168,95,0,1263,95,0.0000,100.0000
NA19185,1112,44,107,1263,151,70.8609,29.1391
NA19189,1153,110,0,1263,110,0.0000,100.0000
NA19190,1106,53,104,1263,157,66.2420,33.7580
NA19197,1102,56,105,1263,161,65.2174,34.7826
NA19198,1155,108,0,1263,108,0.0000,100.0000
NA19200,1159,104,0,1263,104,0.0000,100.0000
NA19204,1104,55,104,1263,159,65.4088,34.5912
NA19207,1156,107,0,1263,107,0.0000,100.0000
NA19209,1108,62,93,1263,155,60.0000,40.0000
NA19213,1155,108,0,1263,108,0.0000,100.0000
NA19222,1104,50,109,1263,159,68.5535,31.4465
NA19223,1158,105,0,1263,105,0.0000,100.0000
NA19225,1114,62,87,1263,149,58.3893,41.6107
NA19235,1104,49,110,1263,159,69.1824,30.8176
NA19236,1152,111,0,1263,111,0.0000,100.0000
NA19247,1113,64,86,1263,150,57.3333,42.6667
NA19248,1164,99,0,1263,99,0.0000,100.0000
NA19256,1152,111,0,1263,111,0.0000,100.0000
NA19257,1115,47,101,1263,148,68.2432,31.7568
NA19307,1164,99,0,1263,99,0.0000,100.0000
NA19308,1162,101,0,1263,101,0.0000,100.0000
NA19309,1175,88,0,1263,88,0.0000,100.0000
NA19310,1109,52,102,1263,154,66.2338,33.7662
NA19311,1165,98,0,1263,98,0.0000,100.0000
NA19312,1157,106,0,1263,106,0.0000,100.0000
NA19313,1118,53,92,1263,145,63.4483,36.5517
NA19315,1100,59,104,1263,163,63.8037,36.1963
NA19316,1094,55,114,1263,169,67.4556,32.5444
NA19317,1164,99,0,1263,99,0.0000,100.0000
NA19318,1145,118,0,1263,118,0.0000,100.0000
NA19319,1159,104,0,1263,104,0.0000,100.0000
NA19321,1126,47,90,1263,137,65.6934,34.3066
NA19324,1107,47,109,1263,156,69.8718,30.1282
NA19327,1109,59,95,1263,154,61.6883,38.3117
NA19328,1107,56,100,1263,156,64.1026,35.8974
NA19331,1165,98,0,1263,98,0.0000,100.0000
NA19332,1148,105,10,1263,115,8.6957,91.3043
NA19334,1150,113,0,1263,113,0.0000,100.0000
NA19338,1122,51,90,1263,141,63.8298,36.1702
NA19346,1148,115,0,1263,115,0.0000,100.0000
NA19347,1159,104,0,1263,104,0.0000,100.0000
NA19350,1158,105,0,1263,105,0.0000,100.0000
NA19351,1121,51,91,1263,142,64.0845,35.9155
NA19352,1158,105,0,1263,105,0.0000,100.0000
NA19355,1107,47,109,1263,156,69.8718,30.1282
NA19359,1162,101,0,1263,101,0.0000,100.0000
NA19360,1157,106,0,1263,106,0.0000,100.0000
NA19371,1162,101,0,1263,101,0.0000,100.0000
NA19372,1164,99,0,1263,99,0.0000,100.0000
NA19373,1149,114,0,1263,114,0.0000,100.0000
NA19374,1156,107,0,1263,107,0.0000,100.0000
NA19375,1149,114,0,1263,114,0.0000,100.0000
NA19376,1160,103,0,1263,103,0.0000,100.0000
NA19377,1098,59,106,1263,165,64.2424,35.7576
NA19379,1103,48,112,1263,160,70.0000,30.0000
NA19380,1151,112,0,1263,112,0.0000,100.0000
NA19381,1105,53,105,1263,158,66.4557,33.5443
NA19382,1156,107,0,1263,107,0.0000,100.0000
NA19383,1176,87,0,1263,87,0.0000,100.0000
NA19384,1149,114,0,1263,114,0.0000,100.0000
NA19385,1166,97,0,1263,97,0.0000,100.0000
NA19390,1117,43,103,1263,146,70.5479,29.4521
NA19391,1128,54,81,1263,135,60.0000,40.0000
NA19393,1149,114,0,1263,114,0.0000,100.0000
NA19394,1164,99,0,1263,99,0.0000,100.0000
NA19395,1119,64,80,1263,144,55.5556,44.4444
NA19396,1101,48,114,1263,162,70.3704,29.6296
NA19397,1164,99,0,1263,99,0.0000,100.0000
NA19398,1099,48,116,1263,164,70.7317,29.2683
NA19399,1099,62,102,1263,164,62.1951,37.8049
NA19401,1106,58,99,1263,157,63.0573,36.9427
NA19403,1120,51,92,1263,143,64.3357,35.6643
NA19404,1105,56,102,1263,158,64.5570,35.4430
NA19428,1160,103,0,1263,103,0.0000,100.0000
NA19429,1170,93,0,1263,93,0.0000,100.0000
NA19430,1184,79,0,1263,79,0.0000,100.0000
NA19431,1105,54,104,1263,158,65.8228,34.1772
NA19434,1108,53,102,1263,155,65.8065,34.1935
NA19435,1107,64,92,1263,156,58.9744,41.0256
NA19436,1101,62,100,1263,162,61.7284,38.2716
NA19437,1117,47,99,1263,146,67.8082,32.1918
NA19438,1104,50,109,1263,159,68.5535,31.4465
NA19439,1118,49,96,1263,145,66.2069,33.7931
NA19440,1106,62,95,1263,157,60.5096,39.4904
NA19443,1168,95,0,1263,95,0.0000,100.0000
NA19444,1173,90,0,1263,90,0.0000,100.0000
NA19445,1109,53,101,1263,154,65.5844,34.4156
NA19446,1102,51,110,1263,161,68.3230,31.6770
NA19448,1165,98,0,1263,98,0.0000,100.0000
NA19449,1107,53,103,1263,156,66.0256,33.9744
NA19451,1162,101,0,1263,101,0.0000,100.0000
NA19452,1175,88,0,1263,88,0.0000,100.0000
NA19453,1155,108,0,1263,108,0.0000,100.0000
NA19455,1141,122,0,1263,122,0.0000,100.0000
NA19456,1106,53,104,1263,157,66.2420,33.7580
NA19457,1095,53,115,1263,168,68.4524,31.5476
NA19461,1155,108,0,1263,108,0.0000,100.0000
NA19462,1106,57,100,1263,157,63.6943,36.3057
NA19463,1093,54,116,1263,170,68.2353,31.7647
NA19466,1162,101,0,1263,101,0.0000,100.0000
NA19467,1117,56,90,1263,146,61.6438,38.3562
NA19468,1116,52,95,1263,147,64.6259,35.3742
NA19469,1107,51,105,1263,156,67.3077,32.6923
NA19470,1105,49,109,1263,158,68.9873,31.0127
NA19471,1084,53,126,1263,179,70.3911,29.6089
NA19472,1095,52,116,1263,168,69.0476,30.9524
NA19473,1110,53,100,1263,153,65.3595,34.6405
NA19474,1089,50,124,1263,174,71.2644,28.7356
NA19625,1108,46,109,1263,155,70.3226,29.6774
NA19648,1160,44,59,1263,103,57.2816,42.7184
NA19651,1154,44,65,1263,109,59.6330,40.3670
NA19652,1188,75,0,1263,75,0.0000,100.0000
NA19654,1156,50,57,1263,107,53.2710,46.7290
NA19655,1182,81,0,1263,81,0.0000,100.0000
NA19657,1153,49,61,1263,110,55.4545,44.5455
NA19660,1148,48,67,1263,115,58.2609,41.7391
NA19661,1179,84,0,1263,84,0.0000,100.0000
NA19663,1147,53,63,1263,116,54.3103,45.6897
NA19664,1184,79,0,1263,79,0.0000,100.0000
NA19672,1150,41,72,1263,113,63.7168,36.2832
NA19675,1154,41,68,1263,109,62.3853,37.6147
NA19676,1174,89,0,1263,89,0.0000,100.0000
NA19678,1147,47,69,1263,116,59.4828,40.5172
NA19679,1191,72,0,1263,72,0.0000,100.0000
NA19681,1134,46,83,1263,129,64.3411,35.6589
NA19682,1186,77,0,1263,77,0.0000,100.0000
NA19684,1158,43,62,1263,105,59.0476,40.9524
NA19685,1180,83,0,1263,83,0.0000,100.0000
NA19700,1161,102,0,1263,102,0.0000,100.0000
NA19701,1123,39,101,1263,140,72.1429,27.8571
NA19703,1147,116,0,1263,116,0.0000,100.0000
NA19704,1120,42,101,1263,143,70.6294,29.3706
NA19707,1136,43,84,1263,127,66.1417,33.8583
NA19711,1170,93,0,1263,93,0.0000,100.0000
NA19712,1105,45,113,1263,158,71.5190,28.4810
NA19713,1110,46,107,1263,153,69.9346,30.0654
NA19716,1157,51,55,1263,106,51.8868,48.1132
NA19717,1183,80,0,1263,80,0.0000,100.0000
NA19719,1147,42,74,1263,116,63.7931,36.2069
NA19720,1171,92,0,1263,92,0.0000,100.0000
NA19722,1158,45,60,1263,105,57.1429,42.8571
NA19723,1187,76,0,1263,76,0.0000,100.0000
NA19725,1146,42,75,1263,117,64.1026,35.8974
NA19726,1171,92,0,1263,92,0.0000,100.0000
NA19728,1155,53,55,1263,108,50.9259,49.0741
NA19729,1190,73,0,1263,73,0.0000,100.0000
NA19731,1158,52,53,1263,105,50.4762,49.5238
NA19732,1185,78,0,1263,78,0.0000,100.0000
NA19734,1155,53,55,1263,108,50.9259,49.0741
NA19735,1187,76,0,1263,76,0.0000,100.0000
NA19737,1166,40,57,1263,97,58.7629,41.2371
NA19738,1178,85,0,1263,85,0.0000,100.0000
NA19740,1148,47,68,1263,115,59.1304,40.8696
NA19741,1191,72,0,1263,72,0.0000,100.0000
NA19746,1134,39,90,1263,129,69.7674,30.2326
NA19747,1190,73,0,1263,73,0.0000,100.0000
NA19749,1154,53,56,1263,109,51.3761,48.6239
NA19750,1193,70,0,1263,70,0.0000,100.0000
NA19752,1157,48,58,1263,106,54.7170,45.2830
NA19753,1183,80,0,1263,80,0.0000,100.0000
NA19755,1154,43,66,1263,109,60.5505,39.4495
NA19756,1176,87,0,1263,87,0.0000,100.0000
NA19758,1140,45,78,1263,123,63.4146,36.5854
NA19759,1178,85,0,1263,85,0.0000,100.0000
NA19761,1150,52,61,1263,113,53.9823,46.0177
NA19762,1186,77,0,1263,77,0.0000,100.0000
NA19764,1151,53,59,1263,112,52.6786,47.3214
NA19770,1151,41,71,1263,112,63.3929,36.6071
NA19771,1193,70,0,1263,70,0.0000,100.0000
NA19773,1143,47,73,1263,120,60.8333,39.1667
NA19774,1191,72,0,1263,72,0.0000,100.0000
NA19776,1146,44,73,1263,117,62.3932,37.6068
NA19777,1178,85,0,1263,85,0.0000,100.0000
NA19779,1144,46,73,1263,119,61.3445,38.6555
NA19780,1174,89,0,1263,89,0.0000,100.0000
NA19782,1155,49,59,1263,108,54.6296,45.3704
NA19783,1187,76,0,1263,76,0.0000,100.0000
NA19785,1152,42,69,1263,111,62.1622,37.8378
NA19786,1185,78,0,1263,78,0.0000,100.0000
NA19788,1161,48,54,1263,102,52.9412,47.0588
NA19789,1171,92,0,1263,92,0.0000,100.0000
NA19794,1146,39,78,1263,117,66.6667,33.3333
NA19795,1185,78,0,1263,78,0.0000,100.0000
NA19818,1162,101,0,1263,101,0.0000,100.0000
NA19819,1110,53,100,1263,153,65.3595,34.6405
NA19834,1173,90,0,1263,90,0.0000,100.0000
NA19835,1105,47,111,1263,158,70.2532,29.7468
NA19900,1159,104,0,1263,104,0.0000,100.0000
NA19901,1097,53,113,1263,166,68.0723,31.9277
NA19904,1166,97,0,1263,97,0.0000,100.0000
NA19908,1161,102,0,1263,102,0.0000,100.0000
NA19909,1124,56,83,1263,139,59.7122,40.2878
NA19914,1123,40,100,1263,140,71.4286,28.5714
NA19916,1154,109,0,1263,109,0.0000,100.0000
NA19917,1100,61,102,1263,163,62.5767,37.4233
NA19920,1154,109,0,1263,109,0.0000,100.0000
NA19921,1118,43,102,1263,145,70.3448,29.6552
NA19922,1152,111,0,1263,111,0.0000,100.0000
NA19923,1124,38,101,1263,139,72.6619,27.3381
NA19982,1150,113,0,1263,113,0.0000,100.0000
NA19984,1178,85,0,1263,85,0.0000,100.0000
NA19985,1110,43,110,1263,153,71.8954,28.1046
NA20126,1161,102,0,1263,102,0.0000,100.0000
NA20127,1111,41,111,1263,152,73.0263,26.9737
NA20276,1121,50,92,1263,142,64.7887,35.2113
NA20278,1156,107,0,1263,107,0.0000,100.0000
NA20281,1161,102,0,1263,102,0.0000,100.0000
NA20282,1113,57,93,1263,150,62.0000,38.0000
NA20287,1121,50,92,1263,142,64.7887,35.2113
NA20289,1095,63,105,1263,168,62.5000,37.5000
NA20291,1159,104,0,1263,104,0.0000,100.0000
NA20294,1120,50,93,1263,143,65.0350,34.9650
NA20296,1109,52,102,1263,154,66.2338,33.7662
NA20298,1168,95,0,1263,95,0.0000,100.0000
NA20299,1110,37,116,1263,153,75.8170,24.1830
NA20314,1150,51,62,1263,113,54.8673,45.1327
NA20317,1099,50,114,1263,164,69.5122,30.4878
NA20322,1112,49,102,1263,151,67.5497,32.4503
NA20332,1127,52,84,1263,136,61.7647,38.2353
NA20334,1117,49,97,1263,146,66.4384,33.5616
NA20336,1119,44,100,1263,144,69.4444,30.5556
NA20339,1107,55,101,1263,156,64.7436,35.2564
NA20340,1153,110,0,1263,110,0.0000,100.0000
NA20341,1080,58,125,1263,183,68.3060,31.6940
NA20342,1162,101,0,1263,101,0.0000,100.0000
NA20344,1122,52,89,1263,141,63.1206,36.8794
NA20346,1159,104,0,1263,104,0.0000,100.0000
NA20348,1184,79,0,1263,79,0.0000,100.0000
NA20351,1169,94,0,1263,94,0.0000,100.0000
NA20356,1169,94,0,1263,94,0.0000,100.0000
NA20357,1101,53,109,1263,162,67.2840,32.7160
NA20359,1100,47,116,1263,163,71.1656,28.8344
NA20363,1104,50,109,1263,159,68.5535,31.4465
NA20412,1110,46,107,1263,153,69.9346,30.0654
NA20414,1112,36,115,1263,151,76.1589,23.8411
NA20502,1155,39,69,1263,108,63.8889,36.1111
NA20503,1155,43,65,1263,108,60.1852,39.8148
NA20504,1157,45,61,1263,106,57.5472,42.4528
NA20505,1160,38,65,1263,103,63.1068,36.8932
NA20506,1183,67,13,1263,80,16.2500,83.7500
NA20507,1154,47,62,1263,109,56.8807,43.1193
NA20508,1165,35,63,1263,98,64.2857,35.7143
NA20509,1195,68,0,1263,68,0.0000,100.0000
NA20510,1192,71,0,1263,71,0.0000,100.0000
NA20512,1192,71,0,1263,71,0.0000,100.0000
NA20513,1191,72,0,1263,72,0.0000,100.0000
NA20515,1193,70,0,1263,70,0.0000,100.0000
NA20516,1189,74,0,1263,74,0.0000,100.0000
NA20517,1153,48,62,1263,110,56.3636,43.6364
NA20518,1188,75,0,1263,75,0.0000,100.0000
NA20519,1192,71,0,1263,71,0.0000,100.0000
NA20520,1187,76,0,1263,76,0.0000,100.0000
NA20521,1194,69,0,1263,69,0.0000,100.0000
NA20522,1152,39,72,1263,111,64.8649,35.1351
NA20524,1186,77,0,1263,77,0.0000,100.0000
NA20525,1191,72,0,1263,72,0.0000,100.0000
NA20527,1193,70,0,1263,70,0.0000,100.0000
NA20528,1185,78,0,1263,78,0.0000,100.0000
NA20529,1160,40,63,1263,103,61.1650,38.8350
NA20530,1177,67,19,1263,86,22.0930,77.9070
NA20531,1160,35,68,1263,103,66.0194,33.9806
NA20532,1196,67,0,1263,67,0.0000,100.0000
NA20533,1169,48,46,1263,94,48.9362,51.0638
NA20534,1184,79,0,1263,79,0.0000,100.0000
NA20535,1164,43,56,1263,99,56.5657,43.4343
NA20536,1190,73,0,1263,73,0.0000,100.0000
NA20537,1194,69,0,1263,69,0.0000,100.0000
NA20538,1187,76,0,1263,76,0.0000,100.0000
NA20539,1189,74,0,1263,74,0.0000,100.0000
NA20540,1165,38,60,1263,98,61.2245,38.7755
NA20541,1152,43,68,1263,111,61.2613,38.7387
NA20542,1150,43,70,1263,113,61.9469,38.0531
NA20543,1193,70,0,1263,70,0.0000,100.0000
NA20544,1198,65,0,1263,65,0.0000,100.0000
NA20581,1188,75,0,1263,75,0.0000,100.0000
NA20582,1159,48,56,1263,104,53.8462,46.1538
NA20585,1149,49,65,1263,114,57.0175,42.9825
NA20586,1192,71,0,1263,71,0.0000,100.0000
NA20588,1190,73,0,1263,73,0.0000,100.0000
NA20589,1155,42,66,1263,108,61.1111,38.8889
NA20752,1186,77,0,1263,77,0.0000,100.0000
NA20753,1153,53,57,1263,110,51.8182,48.1818
NA20754,1202,61,0,1263,61,0.0000,100.0000
NA20755,1188,75,0,1263,75,0.0000,100.0000
NA20756,1154,45,64,1263,109,58.7156,41.2844
NA20757,1160,50,53,1263,103,51.4563,48.5437
NA20758,1187,76,0,1263,76,0.0000,100.0000
NA20759,1196,67,0,1263,67,0.0000,100.0000
NA20760,1161,43,59,1263,102,57.8431,42.1569
NA20761,1156,42,65,1263,107,60.7477,39.2523
NA20765,1191,72,0,1263,72,0.0000,100.0000
NA20766,1141,42,80,1263,122,65.5738,34.4262
NA20768,1158,49,56,1263,105,53.3333,46.6667
NA20769,1168,43,52,1263,95,54.7368,45.2632
NA20770,1192,71,0,1263,71,0.0000,100.0000
NA20771,1161,44,58,1263,102,56.8627,43.1373
NA20772,1156,39,68,1263,107,63.5514,36.4486
NA20773,1166,36,61,1263,97,62.8866,37.1134
NA20774,1153,52,58,1263,110,52.7273,47.2727
NA20775,1152,43,68,1263,111,61.2613,38.7387
NA20778,1177,86,0,1263,86,0.0000,100.0000
NA20783,1179,84,0,1263,84,0.0000,100.0000
NA20785,1193,70,0,1263,70,0.0000,100.0000
NA20786,1159,40,64,1263,104,61.5385,38.4615
NA20787,1185,78,0,1263,78,0.0000,100.0000
NA20790,1152,39,72,1263,111,64.8649,35.1351
NA20792,1191,72,0,1263,72,0.0000,100.0000
NA20795,1160,46,57,1263,103,55.3398,44.6602
NA20796,1179,84,0,1263,84,0.0000,100.0000
NA20797,1169,47,47,1263,94,50.0000,50.0000
NA20798,1197,66,0,1263,66,0.0000,100.0000
NA20799,1163,36,64,1263,100,64.0000,36.0000
NA20800,1160,40,63,1263,103,61.1650,38.8350
NA20801,1186,77,0,1263,77,0.0000,100.0000
NA20802,1149,34,80,1263,114,70.1754,29.8246
NA20803,1193,70,0,1263,70,0.0000,100.0000
NA20804,1157,36,70,1263,106,66.0377,33.9623
NA20805,1188,75,0,1263,75,0.0000,100.0000
NA20806,1191,72,0,1263,72,0.0000,100.0000
NA20807,1163,38,62,1263,100,62.0000,38.0000
NA20808,1150,51,62,1263,113,54.8673,45.1327
NA20809,1194,69,0,1263,69,0.0000,100.0000
NA20810,1190,73,0,1263,73,0.0000,100.0000
NA20811,1188,75,0,1263,75,0.0000,100.0000
NA20812,1188,75,0,1263,75,0.0000,100.0000
NA20813,1160,48,55,1263,103,53.3981,46.6019
NA20814,1181,82,0,1263,82,0.0000,100.0000
NA20815,1189,74,0,1263,74,0.0000,100.0000
NA20816,1188,75,0,1263,75,0.0000,100.0000
NA20818,1162,46,55,1263,101,54.4554,45.5446
NA20819,1148,43,72,1263,115,62.6087,37.3913
NA20826,1147,47,69,1263,116,59.4828,40.5172
NA20828,1154,48,61,1263,109,55.9633,44.0367
